Kostja-Cas9-R1	TACCAAACAGGCCGTTCTTC
Kostja-CMV-DsRed-PciI-f	tagtaaacatgtacggggtcattagttcatagcc
Kostja-CMV-E1f	cagcagACATGTagtttatcgataagcttggga
Kostja-CMV-f	ATAGGGACTTNCCATTGACGTCAATGGGTG
Kostja-CMV-Kozak-R	cCATggtggcggcTCTGACGGTTCACTAAACC
Kostja-CMV-Pr1	tcggtgtcttctatggaggtcaaaacagcgtggat
Kostja-CMV-Pr1-koz	gctcaccatggtggcgaggtcaaaacagcgtggat
Kostja-CMV-r	ACCGCCCANTTGCGTCAATGGGGCGGAGTT
Kostja-CMV-Tomato-f	catagaagacaccgaatggtgagcaagggcgagga
Kostja-CMV-Tomato-F-Koz	gacctcgccaccatggtgagcaagggcgagga
Kostja-Cox8-Kozak-F	gccgccaccATGgCCGTCCTGACGCCGCTGCT
Kostja-DsRed-1R	gcgtgatgaacttcgaggac
Kostja-DsRed-PA-r	tatgatcagttacaggaacaggtggtggcggc
Kostja-DsRsd-2F	gtcctcgaagttcatcacgc
Kostja-DT-A_seq-f	tgtggaattgtgagcggata
Kostja-DT-A_seq-r	cactagctggtggatggaca
Kostja-DT-A-f	GGCCCGGTACCAGATCTATAGATCATGAG
Kostja-DTA-int-f	ACTTTTAGTGCGAGAACCTTCG
Kostja-DTA-int-r	CGAAGGTTCTCGCACTAAAAGT
Kostja-DT-A-NdeI-f	agcttCATATGAGATCTATAGATCATGAG
Kostja-DTA-PspOMI-r	GAGCTCgggcccCGGAGACGGTCACAGCTT
Kostja-DT-A-r	CATGCggtaccCGGAGACGGTCACAGCTT
Kostja-DTA-SalI-f	AAGCTTgtcgacAGATCTATAGATCATGAG
Kostja-DT-A-SalI-r	agctcGTCGACCGGAGACGGTCACAGCTT
Kostja-EGFP-f	gcacaagctggagtacaactacaacagcca
Kostja-EGFP-Lox-U	acttgtacagcNcgtccatgccgagagtgatc
Kostja-EGFP-r	tggctgttgtagttgtactccagcttgtgc
Kostja-EGFP-TubbP	ccgcgtgaagtcagcatggtgagcaagggcgagga
Kostja-Ex1-EcoRI	atcaagGAATTctgtctgccacttgctgtgt
Kostja-Ex1-P2A-U	atgagggagaNcgtgcacatccaggccggc
Kostja-f1-ori-r	taacgcgaattctaacaaaatattaacgctt
Kostja-Fr1.F	atgcctgcaggtcgactcctgattctgcttcc
Kostja-Fr1.R	ttgtacagctcgtccatgccgagagtgat
Kostja-Fr2.F	ggcatggacgagctgtacaagtcatattcaat
Kostja-Fr2.R	atctccctcattggcccgggattctcttcg
Kostja-Fr3.F	atcccgggccaatgagggagatcgtgcacat
Kostja-Fr3.R	accatgattacgaattctgtctgccacttgctgtg
Kostja-gBlock1-f	ATGGGCGGNAGGCGTGTACGGTGGGAGG
Kostja-gBlock1-r	ATGAGGTTCNTCTTTATGCTGTGGCGATC
Kostja-gBlock2-f	AGAAAGCGGNACACCTCTACAAAGGAGGT
Kostja-gBlock2-r	AGAAGCCGNAGCCCATCACGTGGCTCAG
Kostja-gBlock3-f	AGCTGGGCANCGTGGAGTACCAGCACGCC
Kostja-gBlock3-r	ACATGTTCTTNCCTGCGTTATCCCCTGATT
Kostja-gBlock4-f	ATCAGGGTTANTGTCTCATGAGCGGATACA
Kostja-gBlock4-r	AAAGTCCCTANTGGCGTTACTATGGGAACA
Kostja-GFP-G0	gaacttcaagatccgccacaacatcgaggac
Kostja-GFP-G2	gcgatcacatggtcctgctggagttcgtgac
Kostja-GSG-k	AAGGCTAGCggaagcgga
Kostja-hCas9-f	AGAACCTCANTGGCGCCCTCCTGTTCGAC
Kostja-hCas9-r	ACCGCTTTCNGTCTATGGTGGTGTCGAAG
Kostja-Ins-EGFP-RLC	ggacttgaagaagtcgtgctg
Kostja-Ins-FRC	cagcctctgttccacatacact
Kostja-Int-1F	agtcgggattgagcacagaa
Kostja-Int-3F	tggggtgcctaatgagtgag
Kostja-L-for	GTGGAATTGTGAGCGGATAAC
Kostja-Lox-EGFP-U	agctgtacaagNcatattcaataacccttaat
Kostja-Lox-P2A	ggctccgcttccagtgaacctcttcgagggaccta
Kostja-L-rev	CCCGGGATTCTCTTCGACATC
Kostja-M13.F	GTAAAACGACGGCCAGT
Kostja-M13.R	CAGGAAACAGCTATGAC
Kostja-Ori-2R	gtagcaccgcctacatacct
Kostja-Ori-3R	gtttcgccacctctgacttg
Kostja-Ori-f	AAAGAACATGNGAGCAAAAGGCCAGCAAAA
Kostja-P2a-Ex1-U	atctccctcaNtggcccgggattctcttcg
Kostja-P2A-GSG	cccaaggctagcggaagcggagccactaacttctccctgt
Kostja-P2A-lox	cgaagaggttcactggaagcggagccactaacttc
Kostja-P2A-rev	gcttggctggacgtaaactc
Kostja-pCR8_F1	TTGATGCCTGGCAGTTCCCT
Kostja-pCR8_R1	CGAACCGAACAGGCTTATGT
Kostja-PGK-r	ctaaagcgcatgctccagact
Kostja-pUC-Ori-f	GGGATAACGCAGGAAAGAACATGTGA
Kostja-Red2A F	CCCGGCTACTACTACGTGGA	Nariman Nastya
Kostja-R-for	TGGTCGAGATCCGGAACCCTT
Kostja-R-rev	TCCCAGTCACGACGTTGTAAA
Kostja-SeqTALEN_5-1	CATCGCGCAATGCACTGAC
Kostja-SV40PA-DsRed-f	acctgttcctgtaactgatcataatcagccatac
Kostja-SV40PA-Ori-r	ctttcctgcgttatcccACGCCTTAAGATACATTGATGA
Kostja-SV40PA-PciI-r	cgcttaacatgtacgcgttaagatacattg
Kostja-T2mut-F	gtgaggctgagATgtcAggTgtcctgcgtcc
Kostja-T2mut-R	ggacgcaggacAccTgacATctcagcctcac
Kostja-TAL_F1	TTGGCGTCGGCAAACAGTGG
Kostja-TAL_R2	GGCGACGAGGTGGTCGTTGG
Kostja-TAL1-2L-SDM-for	tccgagtaTcaAcaAtaTcaAgaTgccactgcgga
Kostja-TAL1-2L-SDM-rev	tccgcagtggcAtcTtgAtaTtgTtgAtactcgga
Kostja-TAL3Rn-SDM-for	accagctcatGaAgTAtGATagCAtaaagtccttc
Kostja-TAL3Rn-SDM-rev	gaaggactttaTGctATCaTAcTtCatgagctggt
Kostja-TAL3R-SDM-for	tcaccagctcattaAgTAtGATagCAtTC
Kostja-TAL3R-SDM-rev	GAaTGctATCaTAcTtaatgagctggtga
Kostja-TALR2_Seq	ccctttttcactgcatcc
Kostja-Tomato-r	ggtagcacatgtattgctacttgtgattgctc
Kostja-TRPV1 1F	actctgtggtccccaagatg
Kostja-TRPV1 1R	tcctcataagggcagtccat
Kostja-TRPV1 2-3 R	gacaacagagctgacggtga
Kostja-TRPV1 2-3F	ggaggcacagctctgaaaac
Kostja-TRPV1-gRNA1-F	tttcttggctttatatatcttgtggaaaggacgaaacaccgctggaggcggcttggagtt
Kostja-TRPV1-gRNA1-R	gactagccttattttaacttgctatttctagctctaaaacaactccaagccgcctccagc
Kostja-TRPV1-gRNA2-F	tttcttggctttatatatcttgtggaaaggacgaaacaccgtccgggcaggagttctctt
Kostja-TRPV1-gRNA2-R	gactagccttattttaacttgctatttctagctctaaaacaagagaactcctgcccggac
Kostja-TRPV1-gRNA3-F	tttcttggctttatatatcttgtggaaaggacgaaacaccgaaaagccgggtgcgactcc
Kostja-TRPV1-gRNA3-R	gactagccttattttaacttgctatttctagctctaaaacggagtcgcacccggcttttc
Kostja-Tubb3_LS-f	agatgtcgtgcggaaagagt
Kostja-Tubb3_LS-r	gaacttcagggtcagcttgc
Kostja-Tubb3_RS-f	gcctgaagaacgagatcagc
Kostja-Tubb3_RS-r	atggagccagtacagggttg
Kostja-Tubb3-3R	TCTCCAATACCAGGCAGAGG
Kostja-Tubb3-5F	GTCAAGGTAGCCGTGTGTGA
Kostja-Tubb3-Asc	GGGCGGCGCGCCAGTTGCTCGCAGCTGGGGTG
Kostja-Tubb3-Bam	TCACGGATCCGGGGCACAGGCTCAGGCATG
Kostja-Tubb3-FLC	ctcataggtcagagtggtgctg
Kostja-Tubb3-gRNA1-F	tttcttggctttatatatcttgtggaaaggacgaaacaccgcgccgcgccctcttataag
Kostja-Tubb3-gRNA1-R	gactagccttattttaacttgctatttctagctctaaaaccttataagagggcgcggcgc
Kostja-Tubb3-gRNA2-F	tttcttggctttatatatcttgtggaaaggacgaaacaccgggggacgcaggacgccgga
Kostja-Tubb3-gRNA2-R	gactagccttattttaacttgctatttctagctctaaaactccggcgtcctgcgtccccc
Kostja-Tubb3-gRNA3-F	tttcttggctttatatatcttgtggaaaggacgaaacaccggcaagtctggccgcgcctt
Kostja-Tubb3-gRNA3-R	gactagccttattttaacttgctatttctagctctaaaacaaggcgcggccagacttgcc
Kostja-Tubb3-Nhe	AGCAGCTAGCCTTGGGCCCCTGGGCTTCCG
Kostja-Tubb3-Not	GTAGGCGGCCGCGGAAGAATGCTGGATATGAG
Kostja-Tubb3-RRC	caggtagcccttctcaaaagc
Kostja-TubbP-DTA-r	ggtacaagtgagggtgaagagg
Kostja-TubbP-EGFP	gcccttgctcaccatgctgacttcacgcggctaga
Kostja-TubbP-Sal	atttgccagctgtcctgattctgcttcccaat
Kostja-TubbP-SalI	atttgcGTCGACtcctgattctgcttcccaat
Kostja-TurboGFP-f	ACGGCTTCNACCACTTCGGCACCTACCC
Kostja-TurboGFP-r	ATGCCCAGCNCGGTGTTGCTGTGATCCTC
Kostja-VpUC18.F	gacagaattcgtaatcatggtcatagctgtttcct
Kostja-VpUC18.R	aggagtcgacctgcaggcatgc