gRNA_31	AAAAGCACCGACTCGGTGCC	gRNA_31 : AAAAGCACCGACTCGGTGCC
51_31_gRNA_CNTN6_end_Clon_vect	aaacCAGGACAGGATGATACCAGTc	51_31_gRNA_CNTN6_end_Clon_vect             5 aaacCAGGACAGGATGATACCAGTc 3
51_31_gRNA_CNTN6_end_Clon_vect	aaacCAGGACAGGATGATACCAGTc	51_31_gRNA_CNTN6_end_Clon_vect         5 aaacCAGGACAGGATGATACCAGTc 3
caccgGGTGCTTTCTCGGTGAAGGG3	aaacCCCTTCACCGAGAAAGCACCc	caccgGGTGCTTTCTCGGTGAAGGG3             67 5aaacCCCTTCACCGAGAAAGCACCc3
gRNAEGFPclR	aaacccggcaagctgcccgtgccc	gRNAEGFPclR : 5'-aaacccggcaagctgcccgtgccc-3'
caccgGAGCACATGGTAAACGCAGG3	aaacCCTGCGTTTACCATGTGCTCc	caccgGAGCACATGGTAAACGCAGG3             69 5aaacCCTGCGTTTACCATGTGCTCc3
D3S1763F	AAACCGCTGTGCACTTTATC	D3S1763F    AAACCGCTGTGCACTTTATC
53_32_gRNA_CNTN6_start_Clon_vect	aaacCTCTCAATATTATCGCCTGCc	53_32_gRNA_CNTN6_start_Clon_vect         5aaacCTCTCAATATTATCGCCTGCc 3
53_32_gRNA_CNTN6_start_Clon_vect	aaacCTCTCAATATTATCGCCTGCc	53_32_gRNA_CNTN6_start_Clon_vect             5aaacCTCTCAATATTATCGCCTGCc 3
caccgGGTAATATAGTGCGCCAAAG3	aaacCTTTGGCGCACTATATTACCc	caccgGGTAATATAGTGCGCCAAAG3             65 5aaacCTTTGGCGCACTATATTACCc3
gInsBB_13R:	AAACGCAGAAGAGTTTATGAGTGGC	gInsBB_13R: AAAC GCAGAAGAGTTTATGAGTGG C
55_32_gRNA_CNTN6_end_Clon_vect	aaacGCGGGATACGCTCCCATGACc	55_32_gRNA_CNTN6_end_Clon_vect             5aaacGCGGGATACGCTCCCATGACc 3
55_32_gRNA_CNTN6_end_Clon_vect	aaacGCGGGATACGCTCCCATGACc	55_32_gRNA_CNTN6_end_Clon_vect         5aaacGCGGGATACGCTCCCATGACc 3
up_gfp-DR-tomato_olig	AAACGGGTGGGCCAGGGCACGGGCAGCTTGCCGGGTTTTAGAGCTATGCTGTTTTGAATGGTCCCAAAACCCCTCGCCCTCGCCCTCGATCTCGAACTCGGT	up_gfp-DR-tomato_olig      5'-AAACGGGTGGGCCAGGGCACGGGCAGCTTGCCGGGTTTTAGAGCTATGCTGTTTTGAATGGTCCCAAAACCCCTCGCCCTCGCCCTCGATCTCGAACTCGGT-3'
gInsBB_15R:	AAACGTTTCCATAGCAACCTCATTC	gInsBB_15R: AAAC GTTTCCATAGCAACCTCATT C
49_31_gRNA_CNTN6_start_Clon_vect	aaacTCCGGGATTGTGTTGTCGATc	49_31_gRNA_CNTN6_start_Clon_vect             5 aaacTCCGGGATTGTGTTGTCGATc 3
49_31_gRNA_CNTN6_start_Clon_vect	aaacTCCGGGATTGTGTTGTCGATc	49_31_gRNA_CNTN6_start_Clon_vect         5 aaacTCCGGGATTGTGTTGTCGATc 3
Cdh3F	AAACTTGGGGACAGCAACATCAG	Cdh3F 5'- AAACTTGGGGACAGCAACATCAG-3'
MS2_sg-olig_Csn1S1_3_DOWN	AAACTTGTCAGAAACAAAACCCACC	MS2_sg-olig_Csn1S1_3_DOWN      5'-AAACTTGTCAGAAACAAAACCCACC-3'
NANOG_Mel_For	AAAGAATCTTCACCTATGCC	NANOG_Mel_For   AAAGAATCTTCACCTATGCC
qpcr_LTB_F	AAAGACTGGATGACAGCAAA	qpcr_LTB_F : AAAGACTGGATGACAGCAAA
qLtb	AAAGACTGGATGACAGCAAA	qLtb f: AAAGACTGGATGACAGCAAA
qNvRex1F	AAAGCGTTTTCCACACCCCT	qNvRex1F    AAAGCGTTTTCCACACCCCT
D3S2387F	AAAGCTAGAAGGAGCTGGCT	D3S2387F    AAAGCTAGAAGGAGCTGGCT
C-kit_B_F	aaagtataggaacttcgtATTCTTACCCTCACTAGAGATTC	C-kit_B_F  5' aaagtataggaacttcgtATTCTTACCCTCACTAGAGATTC 3'
Tgfbr3-B_F:	aaagtataggaacttcgtCCCAAATAATGGTTTTCACTCAG	Tgfbr3-B_F: 5' aaagtataggaacttcgtCCCAAATAATGGTTTTCACTCAG 3'
tgfbr_DOWN_F	aaagtataggaacttcgtGGATTGAAGAAGAATCAGTGTAGAG	tgfbr_DOWN_F 5'-aaagtataggaacttcgtGGATTGAAGAAGAATCAGTGTAGAG-3'
Kdr_B_F	aaagtataggaacttcgtTGTCACTGTGGAATCCCAAAC	Kdr_B_F  5' aaagtataggaacttcgtTGTCACTGTGGAATCCCAAAC 3'
kdr_down_F	aaagtataggaacttcgtTGTTCATGACTGGTGGCTCA	kdr_down_F    5' aaagtataggaacttcgtTGTTCATGACTGGTGGCTCA 3'
AFP_Mel_For	AAATGCGTTTCTCGTTGCTT	AFP_Mel_For    AAATGCGTTTCTCGTTGCTT
Seq_CtIP_2	AACACTCCCTTTTAGCAACACTTG	Seq_CtIP_2    5' AACACTCCCTTTTAGCAACACTTG 3'
mEos_Ex1_R	AACATCATCATTGCGGGCTG	mEos_Ex1_R AACATCATCATTGCGGGCTG
101	AACCAATGCTGAGCTCCCTT	101         AACCAATGCTGAGCTCCCTT
5'-atgctccccgggtaactaag-3'	AACCGGAACCCTTAAACATGtC	5'-atgctccccgggtaactaag-3'      downstrM13R 5'-AACCGGAACCCTTAAACATGtC-3'
qpTandemAmpRR	AACGACGAGCGTGACACCAC	qpTandemAmpRR AACGACGAGCGTGACACCAC 20b
qpTandemAmpRR	AACGACGAGCGTGACACCAC	qpTandemAmpRR    AACGACGAGCGTGACACCAC        20b
4C_primer	AACGGCAGTAGAAAGGGCTTC	4C_primer 5_R  5' AACGGCAGTAGAAAGGGCTTC 3'
MS2bb_Seq_R	aacttctcggggactgtggg	MS2bb_Seq_R      5'-aacttctcggggactgtggg-3'
Brachyury	AACTTTCCTCCATGTGCTGAGAC	Brachyury -2,  F: AACTTTCCTCCATGTGCTGAGAC
Brachyury	AACTTTCCTCCATGTGCTGAGAC	Brachyury -2, F: AACTTTCCTCCATGTGCTGAGAC
qCDKI2A	AAGAAGAAGCCATACTTTCCCTATGA	qCDKI2A f: AAGAAGAAGCCATACTTTCCCTATGA
tgfbr_narcheck_R	AAGACAACAACCCCTACCCC	tgfbr_narcheck_R    5'-AAGACAACAACCCCTACCCC-3'
45_T_recomb_R:	AAGAGTACATGGCATTGGGG	45_T_recomb_R: AAGAGTACATGGCATTGGGG
Seq_5H_beg_R	aagatggggaagagaatcagtc	Seq_5H_beg_R    aagatggggaagagaatcagtc
Sox	AAGATTGAGAAAACACGCATGAC	Sox 17R 5'-AAGATTGAGAAAACACGCATGAC-3'
qGtl2r	AAGCACCATGAGCCACTAGG	qGtl2r AAGCACCATGAGCCACTAGG
39_g1chr15cut3RR	AAGCTATGAACCAGATGCCAGTT	39_g1chr15cut3RR    AAGCTATGAACCAGATGCCAGTT
Tub/Tomato-2661:5'	AAGCTCGCTTCACGAGATTC	Tub/Tomato-2661:5' - AAGCTCGCTTCACGAGATTC -
126	AAGGAGACAACGATGTGTTGGA	126 AAGGAGACAACGATGTGTTGGA
D3S3053R	AAGGCAGAAGAGTGAGAGAGC	D3S3053R    AAGGCAGAAGAGTGAGAGAGC
Verminlord-R:	AAGGCCCTGTTTTGCCCTCCTGT	Verminlord-R:        5'-AAGGCCCTGTTTTGCCCTCCTGT-3'
Verminlord-R:	AAGGCCCTGTTTTGCCCTCCTGT	Verminlord-R:    5'-AAGGCCCTGTTTTGCCCTCCTGT-3'
1st	AAGGCTGTTGTACTGCGTGA	1st peak checkF 5'-AAGGCTGTTGTACTGCGTGA-3'
bsIG-DMR-f1	AAGGTATATTATGTTAGTGTTAGGAAGGATTGTGA	bsIG-DMR-f1    5'-AAGGTATATTATGTTAGTGTTAGGAAGGATTGTGA-3'
112	AAGGTGTAATGGGGCTGCAA	112         AAGGTGTAATGGGGCTGCAA
44_T_recomb_F:	AAGTACTCGCCGATAGTGGA	44_T_recomb_F: AAGTACTCGCCGATAGTGGA
EGFP_qPCR_R	AAGTCGATGCCCTTCAGCTC	EGFP_qPCR_R  AAGTCGATGCCCTTCAGCTC
NvDax1F	AAGTGCTTCCTTGCCAAGTG	NvDax1F AAGTGCTTCCTTGCCAAGTG
GFP_oIMR0872:	AAGTTCATCTGCACCACCG	GFP_oIMR0872:  AAGTTCATCTGCACCACCG
GFP_oIMR0872:	AAGTTCATCTGCACCACCG	GFP_oIMR0872: AAGTTCATCTGCACCACCG
tltkPA_54R:	aagttcgggtgaaggccc	tltkPA_54R: aagttcgggtgaaggccc
TAF3_del1_R	AATAAAGATTTGAAAGGGACTCT	TAF3_del1_R    AATAAAGATTTGAAAGGGACTCT
bsIG-DMR-r2	AATACAACCCTTCCCTCACTCCAAAAATTAAAAAA	bsIG-DMR-r2    5'-AATACAACCCTTCCCTCACTCCAAAAATTAAAAAA-3'
G418_R	AATATCACGGGTAGCCAACG	G418_R  5' AATATCACGGGTAGCCAACG 3'
DTA_c-kit_R	aatcattatttggggccAGTGCACCATTCGAGCAG	DTA_c-kit_R  5' aatcattatttggggccAGTGCACCATTCGAGCAG 3'
D3S3053F	AATCCCAAGTGCACAGTGTT	D3S3053F    AATCCCAAGTGCACAGTGTT
cNANOGHayesF	AATCCTGCATCCTTGCCAATGTCC	cNANOGHayesF AATCCTGCATCCTTGCCAATGTCC
CNTN6_Ex5D_F	AATCTGCTTTTCTTTGTTTTCCAAG	CNTN6_Ex5D_F    AATCTGCTTTTCTTTGTTTTCCAAG
M2Red	AATGACCCTGCGCCTTATTT	M2Red F - AATGACCCTGCGCCTTATTT
down	AATGACGACGTGCAGGAAAC	down 5'-AATGACGACGTGCAGGAAAC-3'
CNTN6_Ex1D_F	AATGCAGTGAAACCAGAGGAA	CNTN6_Ex1D_F    AATGCAGTGAAACCAGAGGAA
TAIL-5'Cas9-1	AATGCCAGGCGGGCCATTTACC	TAIL-5'Cas9-1    5'-AATGCCAGGCGGGCCATTTACC-3'
SRY_ME_R	AATGCGTTCATGGGTCGTCT	SRY_ME_R           AATGCGTTCATGGGTCGTCT
22_HPRT_ex6_52:	AATGGCATTGTGTCGTGGAA	22_HPRT_ex6_52: 5' AATGGCATTGTGTCGTGGAA 3'
Trim71i12_31	AATGGGCTCACAGCTTCCCC	Trim71i12_31     5-AATGGGCTCACAGCTTCCCC-3
Tph25UTR_52:	AATGTAACGTCATGCCAGCAG	Tph25UTR_52:           AATGTAACGTCATGCCAGCAG
Tph25UTR_52:	AATGTAACGTCATGCCAGCAG	Tph25UTR_52:         AATGTAACGTCATGCCAGCAG
mtDNA_HhaI_Pr7	aattaatcccctggcccaac	mtDNA_HhaI_Pr7 aattaatcccctggcccaac
5'-3':	AATTCGGATCCGGTACCCTGCA	5'-3':  > Inp1S    AATTCGGATCCGGTACCCTGCA
BRACHYURY_Mel_For	AATTGGTCCAGCCTTGGAAT	BRACHYURY_Mel_For    AATTGGTCCAGCCTTGGAAT
CNTN6_Ex23D_F	ACAAAGACACGGTAAGGCACT	CNTN6_Ex23D_F  ACAAAGACACGGTAAGGCACT
mEos2_53	ACAACAAGGTTAAGCTGTATGAGC	mEos2_53  : ACAACAAGGTTAAGCTGTATGAGC
CNTN6_Ex10D_F	ACAAGCATCTTTATATGCCTTTTCC	CNTN6_Ex10D_F  ACAAGCATCTTTATATGCCTTTTCC
D3S2465F	ACAAGGATGCAGAGGAACAA	D3S2465F    ACAAGGATGCAGAGGAACAA
MycoRomoF:	ACACCATGGGAG	MycoRomoF: ACACCATGGGAGYTGGTAAT
qSkryer-F	ACACCGGGACCGATCCAGCC	qSkryer-F ACACCGGGACCGATCCAGCC
MinkNanog155R	ACACGGTCCTGATCTTCTGT	MinkNanog155R   ACACGGTCCTGATCTTCTGT
D3S2432R	ACACTAAACAAGCATAGTCAGGC	D3S2432R    ACACTAAACAAGCATAGTCAGGC
mtDNA_Pr11	acagacgaggtcaacgatcc	mtDNA_Pr11 acagacgaggtcaacgatcc
D3S2403F	ACAGATTGAGACCATGTGTCA	D3S2403F    ACAGATTGAGACCATGTGTCA
CNTN6_Ex23D2_R	ACAGCAGTTACAACTCCCCAG	CNTN6_Ex23D2_R   ACAGCAGTTACAACTCCCCAG
3'-Skryre-out:	ACAGCCCCCTGCTGTCCATTCCT	3'-Skryre-out: ACAGCCCCCTGCTGTCCATTCCT
CNTN6_Del2_F	ACAGGAGAGTCAACAAGGAGA	CNTN6_Del2_F    5`-ACAGGAGAGTCAACAAGGAGA-3`
Cdc_CheckPrimer_F	ACAGGGGGAATTGACATTTG	Cdc_CheckPrimer_F   5' ACAGGGGGAATTGACATTTG 3'
qpcr_M2rtTA_R	ACAGGGTAGGCTGCTCAACT	qpcr_M2rtTA_R : ACAGGGTAGGCTGCTCAACT
Tph25UTR_53:	ACAGGTAAAATTTGCATAATGTAACG	Tph25UTR_53:         ACAGGTAAAATTTGCATAATGTAACG
CNTN6_Ex12D_R	ACAGGTTTGACACCATAACACA	CNTN6_Ex12D_R  ACAGGTTTGACACCATAACACA
Fw3	ACATCACAGCTGCTGCTTCT	Fw3 5'-ACATCACAGCTGCTGCTTCT
D13Mit64R:	ACATCAGTGACCAGGCATCA	D13Mit64R: 5'-ACATCAGTGACCAGGCATCA
D13Mit64R2:	ACATCAGTGACCAGGCATCA	D13Mit64R2: 5'-ACATCAGTGACCAGGCATCA
H19_Hum_new_OR	ACATCCTAACCCCATCAAAATCCCCAC	H19_Hum_new_OR  ACATCCTAACCCCATCAAAATCCCCAC  27
4C_primer	ACATGGAGACCTAAAAGCTT	4C_primer 2_F  5' ACATGGAGACCTAAAAGCTT 3'
Tomato689F	acatggccgtcatcaaaga	Tomato689F   5'-acatggccgtcatcaaaga
Tub/Tomato-6635:5'	ACATGGCCGTCATCAAAGA	Tub/Tomato-6635:5' - ACATGGCCGTCATCAAAGA -
tgfbr_check_F	ACATGGTCCTGCTGGAGTTC	tgfbr_check_F   5' ACATGGTCCTGCTGGAGTTC 3'
D3S3045F	ACCAAATGAGACAGTGGCAT	D3S3045F    ACCAAATGAGACAGTGGCAT
D3S1768F	ACCACATGAGCCAATTCTGT	D3S1768F    ACCACATGAGCCAATTCTGT
mtDNA_Pr6	accacctcttgctcagccta	mtDNA_Pr6 accacctcttgctcagccta
mEos_Ex2_R	ACCAGCCCACCAACTTCATT	mEos_Ex2_R ACCAGCCCACCAACTTCATT
Ddx3x_Pr1	ACCAGGGTTTCTGCACTAGC	Ddx3x_Pr1 5'-ACCAGGGTTTCTGCACTAGC
CNTN6_Ex12D_F	ACCAGTGTTGAAGAGCCTTACT	CNTN6_Ex12D_F  ACCAGTGTTGAAGAGCCTTACT
CNTN6_Ex13D_F	ACCATAGGCTAGCATTTCATAAGC	CNTN6_Ex13D_F  ACCATAGGCTAGCATTTCATAAGC
D3S1768R	ACCCAATTATGGTGTTGTTACC	D3S1768R    ACCCAATTATGGTGTTGTTACC
hPAX6-S1206	ACCCATTATCCAGATGTGTTTGCCCGAG	hPAX6-S1206    ACC CAT TAT CCA GAT GTG TTT GCC CGA G
mtDNA_F	accgcacaatcccctatcta	mtDNA_F accgcacaatcccctatcta
31_gibbsBrach32	ACCGCATCCCCAGCATGCCTTCCTGGAAAAGACAGCGCAC	31_gibbsBrach32 ACCGCATCCCCAGCATGCCT TCCTGGAAAAGACAGCGCAC
31_gibbsBrach32	ACCGCATCCCCAGCATGCCTTCCTGGAAAAGACAGCGCAC	31_gibbsBrach32 ACCGCATCCCCAGCATGCCT TCCTGGAAAAGACAGCGCAC -
gRNAEGFPclF	accgggcacgggcagcttgccgg	gRNAEGFPclF : 5'-accgggcacgggcagcttgccgg-3'
CNTN6_Ex8D_F	ACCGTCTTCTATTCTAATGAGGTG	CNTN6_Ex8D_F    ACCGTCTTCTATTCTAATGAGGTG
tlRGS512	ACCTCGCTGGACGAGGCCCTG	tlRGS512 ACCTCGCTGGACGAGGCCCTG
Seq_Cas9_end_F	ACCTCTCTCAGCTCGGTGGA	Seq_Cas9_end_F      5' ACCTCTCTCAGCTCGGTGGA 3'
hART5-RT-F	ACCTGGGAGGACAAGCGTCG	hART5-RT-F    5' ACCTGGGAGGACAAGCGTCG 3'
3C_BAC183_F3	ACCTGGGGTGGTTATTGTGA	3C_BAC183_F3 5'-ACCTGGGGTGGTTATTGTGA-3'
Hind_primer_13F	ACCTTTGCTGGAAGAAAAGCTT	Hind_primer_13F  5' ACCTTTGCTGGAAGAAAAGCTT 3'
CNTN6_Ex16D2_R	ACGAAATCTTCCACACTTTTAGAAC	CNTN6_Ex16D2_R    ACGAAATCTTCCACACTTTTAGAAC
Seq_loxp_end_F	acgagatcagcagcctctgt	Seq_loxp_end_F    acgagatcagcagcctctgt
Rex1F	ACGAGTGGCAGTTTCTTCTTGGGA	Rex1F 5-ACGAGTGGCAGTTTCTTCTTGGGA-3
TAIL-5'Cas9-2enh	acgatggaactccagtccggccagggggcgtacttggcatatgatac	TAIL-5'Cas9-2enh    5'-acgatggaactccagtccggccagggggcgtacttggcatatgatac-3'
AC1	ACGATGGACTCCAGAG	AC1        5'-ACGATGGACTCCAGAG    16b
LAD4-1	ACGATGGACTCCAGAGCGGCCGC	LAD4-1 = ACGATGGACTCCAGAGCGGCCGCBDNBNNNCGGT
LAD1-1	ACGATGGACTCCAGAGCGGCCGC	LAD1-1   5'-ACGATGGACTCCAGAGCGGCCGCBNBNNNGGTT-3'
3'-mTghe-redeemer	ACGATGGACTCCAGTCCGGCCACCAGGGGATCTTCCCAACCCAG	3'-mTghe-redeemer = ACGATGGACTCCAGTCCGGCCACCAGGGGATCTTCCCAACCCAG
5'-Skryre-mid:	ACGATGGACTCCAGTCCGGCCACCCGGGTACCGAGCTCGAC	5'-Skryre-mid: ACGATGGACTCCAGTCCGGCCACCCGGGTACCGAGCTCGAC 5'-Skryre-out: AGGCCTCCCACCGTACACGCCT
3'-oTghe-2:	ACGATGGACTCCAGTCCGGCCACTGCAAAAGAAAGTGCAACCTAG	3'-oTghe-2: ACGATGGACTCCAGTCCGGCCACTGCAAAAGAAAGTGCAACCTAG
3'-midT-6330	ACGATGGACTCCAGTCCGGCCCAGATGGTTCTGAAAATTCCATGCTCTAC	3'-midT-6330          ACGATGGACTCCAGTCCGGCCCAGATGGTTCTGAAAATTCCATGCTCTAC
3'-Skryre-mid:	ACGATGGACTCCAGTCCGGCCCCTCCTCTCCTGACTACTCCCAGTC	3'-Skryre-mid: ACGATGGACTCCAGTCCGGCCCCTCCTCTCCTGACTACTCCCAGTC
3'-mTghe-hope	ACGATGGACTCCAGTCCGGCCCTGGTGACCCCAACAGTGGAATCC	3'-mTghe-hope = ACGATGGACTCCAGTCCGGCCCTGGTGACCCCAACAGTGGAATCC
oTghe	ACGATGGACTCCAGTCCGGCCGGAGTGCATCCACCACAATTTGA	oTghe     5'-ACGATGGACTCCAGTCCGGCCGGAGTGCATCCACCACAATTTGA  44b
tlCMV313	acgatggactccagTCcggccTGCCAGGCGGGCCATTTACCGT	tlCMV313 : acgatggactccagTCcggccTGCCAGGCGGGCCATTTACCGT
MAR-mTghe	ACGATGGACTCCAGTCCGGCCTGCCGCAACAAAATTAGCCAATTTCCGTGCTG	MAR-mTghe 5'-ACGATGGACTCCAGTCCGGCCTGCCGCAACAAAATTAGCCAATTTCCGTGCTG-3'
3'oTghe	ACGATGGACTCCAGTCCGGCCTGTGGGTGCACTGGCAATTTGAAC	3'oTghe    5'-ACGATGGACTCCAGTCCGGCCTGTGGGTGCACTGGCAATTTGAAC-3'
3'-oTghe	ACGATGGACTCCAGTCCGGCCTGTGGGTGCACTGGCAATTTGAAC	3'-oTghe ACGATGGACTCCAGTCCGGCCTGTGGGTGCACTGGCAATTTGAAC
Dpn_primer_14R	ACGCGTTTGCTTCTTCTTTG	Dpn_primer_14R  5' ACGCGTTTGCTTCTTCTTTG 3'
qckitF	ACGGGCGGATCACAAAGATT	qckitF 5'-ACGGGCGGATCACAAAGATT-3'
GG-adaptor_DOWN	ACGTACATGTCGCCA	GG-adaptor_DOWN  > ACGTACATGTCGCCA
GG-adaptor_DOWN	ACGTACATGTCGCCA	GG-adaptor_DOWN  >>> ACGTACATGTCGCCA
sg-acasATG2	acgtatcgtctcacaccgAAAAGCAGCAGCCACGAGGCgttttagcgagacgtccgag	sg-acasATG2     5' acgtatcgtctcacaccgAAAAGCAGCAGCCACGAGGCgttttagcgagacgtccgag 3'
sg-nestSTOP-mm	acgtatcgtctcacaccgatggagactcctggtcctcagttttagcgagacgtccgag	sg-nestSTOP-mm     5' acgtatcgtctcacaccgatggagactcctggtcctcagttttagcgagacgtccgag 3'
sg-acas3'KO	acgtatcgtctcacaccgccacacattggttttttcagttttagcgagacgtccgag	sg-acas3'KO     5'-acgtatcgtctcacaccgccacacattggttttttcagttttagcgagacgtccgag-3'
olig_kdr_up	acgtatcgtctcacaccgCCTCTGACAGCTGTCACTGgttttagcgagacgtccgag	olig_kdr_up    5' acgtatcgtctcacaccgCCTCTGACAGCTGTCACTGgttttagcgagacgtccgag 3'
olig_tgfbr3_up	acgtatcgtctcacaccgCTCAGGGACGCCCAAATAAgttttagcgagacgtccgag	olig_tgfbr3_up    5' acgtatcgtctcacaccgCTCAGGGACGCCCAAATAAgttttagcgagacgtccgag 3'
olig_c-kit_up	acgtatcgtctcacaccgCTCAGTAGCCTTTCATCTAgttttagcgagacgtccgag	olig_c-kit_up    5' acgtatcgtctcacaccgCTCAGTAGCCTTTCATCTAgttttagcgagacgtccgag 3'
sg-acas3'KO+	acgtatcgtctcacaccgctgaaaaaaccaatgtgtgggttttagcgagacgtccgag	sg-acas3'KO+     5' acgtatcgtctcacaccgctgaaaaaaccaatgtgtgggttttagcgagacgtccgag 3'
tctcacaccgGTAATTATGGCAAATTATAGgttttagcgagacgtccgag	acgtatcgtctcacaccgCTGAGTAAAGTCTTTAACAAgttttagcgagacgtccgag	tctcacaccgGTAATTATGGCAAATTATAGgttttagcgagacgtccgag      acgtatcgtctcacaccgCTGAGTAAAGTCTTTAACAAgttttagcgagacgtccgag
sg-nestSTOP-hs	acgtatcgtctcacaccgctggtcctcaggggaggactgttttagcgagacgtccgag	sg-nestSTOP-hs     5' acgtatcgtctcacaccgctggtcctcaggggaggactgttttagcgagacgtccgag 3'
gRNA	acgtatcgtctcacaccgGGCACGGGCAGCTTGCCGGgttttagcgagacgtccgag	gRNA EGFP site1 5'-acgtatcgtctcacaccgGGCACGGGCAGCTTGCCGGgttttagcgagacgtccgag
gRNA_EGFP_site1	acgtatcgtctcacaccgGGCACGGGCAGCTTGCCGGgttttagcgagacgtccgag	gRNA_EGFP_site1   acgtatcgtctcacaccgGGCACGGGCAGCTTGCCGGgttttagcgagacgtccgag (
sg-acasATG+	acgtatcgtctcacaccggtgaggatgaggagtttcagttttagcgagacgtccgag	sg-acasATG+     5' acgtatcgtctcacaccggtgaggatgaggagtttcagttttagcgagacgtccgag 3'
sg-acas3'KO2	acgtatcgtctcacaccgTCAGTATCCTTGGAGACAATgttttagcgagacgtccgag	sg-acas3'KO2    5' acgtatcgtctcacaccgTCAGTATCCTTGGAGACAATgttttagcgagacgtccgag 3'
sg-acasATG	acgtatcgtctcacaccgtgaaactcctcatcctcacgttttagcgagacgtccgag	sg-acasATG     5'-acgtatcgtctcacaccgtgaaactcctcatcctcacgttttagcgagacgtccgag-3'
olig_cdc7_up	acgtatcgtctcacaccgTGCCATTATCATCTTACACgttttagcgagacgtccgag	olig_cdc7_up    5' acgtatcgtctcacaccgTGCCATTATCATCTTACACgttttagcgagacgtccgag 3'
tctcacaccgTTCTGCCCAATACCTCTCCTgttttagcgagacgtccgag	acgtatcgtctcacaccgTTCTAAGAATTGTTACAAATgttttagcgagacgtccgag	tctcacaccgTTCTGCCCAATACCTCTCCTgttttagcgagacgtccgag      acgtatcgtctcacaccgTTCTAAGAATTGTTACAAATgttttagcgagacgtccgag
TAF4_dupOUT1_R	ACGTCAGTGGAGACTGATTGG	TAF4_dupOUT1_R   ACGTCAGTGGAGACTGATTGG
CNTN6_Ex10D_R	ACGTCATTTTGAATTTGTTGGTTGT	CNTN6_Ex10D_R  ACGTCATTTTGAATTTGTTGGTTGT
Seq_GMCSF_end_F	ACGTTACCCACTTGCCTGGAC	Seq_GMCSF_end_F    ACGTTACCCACTTGCCTGGAC
Human_U6_Seq_F_Insert	ACTATCATATGCTTACCGTAAC	Human_U6_Seq_F_Insert       5'- ACTATCATATGCTTACCGTAAC-3'
hpH34-AS259	ACTCAGCCATGGACTGGAGCATCC	hpH34-AS259 ACT CAG CCA TGG ACT GGA GCA TCC
c-kit_sse9i_check_R	ACTCAGGGTGTCACATGGAA	c-kit_sse9i_check_R 5'-ACTCAGGGTGTCACATGGAA
13_Hprt_ex6_31	ACTCAGGTTGTCAGGCTTGG	13_Hprt_ex6_31  ACTCAGGTTGTCAGGCTTGG
Sry_Tojo_R:	ACTCCAGTCTTGCCTGTATGTGATG	Sry_Tojo_R:  ACTCCAGTCTTGCCTGTATGTGATG
Seq_RNF169_2	ACTCCTCCCAAGAGACTCCCTG	Seq_RNF169_2      5' ACTCCTCCCAAGAGACTCCCTG 3'
Clon-SV40pA-F	ACTCCTGCAGGCAGCCATACCACATTTGTAGAGG	Clon-SV40pA-F       ACTCCTGCAGGCAGCCATACCACATTTGTAGAGG
Esg1R	ACTCGATACACTGGCCTAGC	Esg1R 5-ACTCGATACACTGGCCTAGC-3
mCNTN5-RT-Ex2_F	ACTCTGAAGCTCTCTCTGGCCTT	mCNTN5-RT-Ex2_F      5' ACTCTGAAGCTCTCTCTGGCCTT 3'
Clon-3short-2-F	ACTGAATTCTGTGGCGCGCCTTCGAAGGCTGCTGCTTTTGCTATGCCCGT	Clon-3short-2-F      ACTGAATTCTGTGGCGCGCCTTCGAAGGCTGCTGCTTTTGCTATGCCCGT
CASCUT-A	ACTGATTCTCTTCCCCATCTTGT	CASCUT-A       F:  ACTGATTCTCTTCCCCATCTTGT
mtDNA_Pr1	actgcaggccacctactcat	mtDNA_Pr1 actgcaggccacctactcat
Clon-GMCSF-F	ACTGCCGGCACATTCTAGAGCGGCCGCATGTGGCTGCAGAGCCTGCTGCTCT	Clon-GMCSF-F      ACTGCCGGCACATTCTAGAGCGGCCGCATGTGGCTGCAGAGCCTGCTGCTCT
q-mNanogR	ACTGGTAGAAGAATCAGGGCT	q-mNanogR  ACTGGTAGAAGAATCAGGGCT    21b
CNTN6_Ex16D_R	ACTGTATCATACGAAATCTTCCACA	CNTN6_Ex16D_R  ACTGTATCATACGAAATCTTCCACA
mCNTN5-RT-Ex13_F	ACTGTTGGAGAGAGCATTGTCCT	mCNTN5-RT-Ex13_F      5' ACTGTTGGAGAGAGCATTGTCCT 3'
CNTN6_Ex15D_F	ACTTCCTAAGCACAACAGGTAA	CNTN6_Ex15D_F  ACTTCCTAAGCACAACAGGTAA
125	AGAAAACTCCACCAGGACCC	125 AGAAAACTCCACCAGGACCC
mEos_51	agaaaattacatcgggagCCATGAGTGCGATTAAGCCAGAC	mEos_51 : agaaaattacatcgggagCCATGAGTGCGATTAAGCCAGAC
TDGF_Mel_Rev	AGAAATGCCTGAGGAAAGCA	TDGF_Mel_Rev   AGAAATGCCTGAGGAAAGCA
EGFP_Alex_F	AGAAGAACGGCATCAAGGTG	EGFP_Alex_F  AGAAGAACGGCATCAAGGTG
qKdrR	AGAAGTCACAGAGGCGGTATG	qKdrR 5'-AGAAGTCACAGAGGCGGTATG-3'
BAC_Smcx_7	AGACAGGAGGGAGGCAGTCT	BAC_Smcx_7   AGACAGGAGGGAGGCAGTCT
30001_bottom	AGACCAGCGAAAACCTTGCCGGGG	30001_bottom 5'-AGACCAGCGAAAACCTTGCCGGGG-3'
NF200_qPCR_F	AGACCCCCGTCAAGGAAGG	NF200_qPCR_F    AGACCCCCGTCAAGGAAGG
127	AGACCTAGGGCTTCAAAGCAAG	127 AGACCTAGGGCTTCAAAGCAAG
SOX1-human	AGACGCTGCTCAAGAAGGAC	SOX1-human        F- AGACGCTGCTCAAGAAGGAC
T4adaptor_up:	agactcgaattCGCAGGCACACgacagctgtcCCTGTCTTGTGTCaacatgtgtacct	T4adaptor_up:   > 5'-agactcgaattCGCAGGCACACgacagctgtcCCTGTCTTGTGTCaacatgtgtacct-3'
qpcr_M2rtTA_F	AGACTGGACAAGAGCAAAGT	qpcr_M2rtTA_F : AGACTGGACAAGAGCAAAGT
Pax-6	AGACTTTAACCAAGGGCGGT	Pax-6       F  AGACTTTAACCAAGGGCGGT
Pax-6	AGACTTTAACCAAGGGCGGT	Pax-6 F AGACTTTAACCAAGGGCGGT
Stella/Dppa3	AGAGAAGGGTCCGCACTTTG	Stella/Dppa3   5' AGAGAAGGGTCCGCACTTTG 3'
Tdo	AGAGCCAGCAAAGGAGGAC	Tdo F AGAGCCAGCAAAGGAGGAC
CNTN6_Ex11D_R	AGAGGAAATTTTGAAAGGCCTACT	CNTN6_Ex11D_R  AGAGGAAATTTTGAAAGGCCTACT
CNTN6_Ex11D2_R	AGAGGAAATTTTGAAAGGCCTACTA	CNTN6_Ex11D2_R   AGAGGAAATTTTGAAAGGCCTACTA
124	AGAGTAGGGACCCAAGACGA	124 AGAGTAGGGACCCAAGACGA
Univ_8F	AGAGTTTGATCCTGGCTCAG	Univ_8F  AGAGTTTGATCCTGGCTCAG
F:5'	AGATAGAGAATCCAGTGAGT	F:5' - AGATAGAGAATCCAGTGAGT -
D15S642R:	AGATGCCGCCTGTACTAATG	D15S642R:  AGATGCCGCCTGTACTAATG
123	AGATGCTGCCCACAGAACTC	123 AGATGCTGCCCACAGAACTC
Short	AGATGGGCTGAAGCAACTGAAG	Short R 5' - AGATGGGCTGAAGCAACTGAAG -
Tph2Int12_31	agcaaacagaatgcttccttaact	Tph2Int12_31 : agcaaacagaatgcttccttaact
CNTN6_Ex20D_R	AGCAAAGGAATAGGTTGCTCT	CNTN6_Ex20D_R  AGCAAAGGAATAGGTTGCTCT
mTbx5F	agcaaatgggcgcgccggATGGCCGATACAGATGAGGGC	mTbx5F 5-agcaaatgggcgcgccggATGGCCGATACAGATGAGGGC-3
mMef2cF	agcaaatgggcgcgccggATGGGGAGAAAAAAGATTCAGATT	mMef2cF 5-agcaaatgggcgcgccggATGGGGAGAAAAAAGATTCAGATT -3
mGata4F	agcaaatgggcgcgccggATGTACCAAAGCCTGGCCATG	mGata4F 5-agcaaatgggcgcgccggATGTACCAAAGCCTGGCCATG-3
Hind_primer_14F	AGCAACAGAACGGAAAGCTT	Hind_primer_14F  5' AGCAACAGAACGGAAAGCTT 3'
primer1	AGCAGAGCTGGTTTAGTGAACCgGGCACGGGCAGCTTGCC	primer1 AGCAGAGCTGGTTTAGTGAACCgGGCACGGGCAGCTTGCC
Primer1	AGCAGAGCTGGTTTAGTGAACCgGGCACGGGCAGCTTGCC	Primer1 5'-AGCAGAGCTGGTTTAGTGAACCgGGCACGGGCAGCTTGCC
BAC_Smcx_1	AGCAGAGGAGGACATGAGGA	BAC_Smcx_1   AGCAGAGGAGGACATGAGGA
5H-R-gibson	agcaggctctgcagccacatggttgccaagatctgttttgag	5H-R-gibson                  5'-agcaggctctgcagccacatggttgccaagatctgttttgag-3'
5H-R-gibson	agcaggctctgcagccacatggttgccaagatctgttttgag	5H-R-gibson              5'-agcaggctctgcagccacatggttgccaagatctgttttgag-3'
5H-R-gibson	agcaggctctgcagccacatggttgccaagatctgttttgag	5H-R-gibson          5'-agcaggctctgcagccacatggttgccaagatctgttttgag-3'
5H-R-gibson	agcaggctctgcagccacatggttgccaagatctgttttgag	5H-R-gibson    5'-agcaggctctgcagccacatggttgccaagatctgttttgag-3'
Concat-bc-R	AGCATACATGTNNACTNNGATNNGGTNNCTATCCTGACCCTGCTTGGCT	Concat-bc-R    5' AGCATACATGTNNACTNNGATNNGGTNNCTATCCTGACCCTGCTTGGCT 3'
CNTN6_Ex11D_F	AGCATAGCAAGTCACCCCTG	CNTN6_Ex11D_F  AGCATAGCAAGTCACCCCTG
Barc_concat_R	AGCATGCTAGCNNACTNNGATNNGGTNNCTATCCTGACCCTGCTTGGCT	Barc_concat_R    5' AGCATGCTAGCNNACTNNGATNNGGTNNCTATCCTGACCCTGCTTGGCT 3'
tlRGS511	AGCCAGAGAAACCAGCCAAGACCCA	tlRGS511 AGCCAGAGAAACCAGCCAAGACCCA
117	AGCCAGCCCTTTCAACTCTC	117 AGCCAGCCCTTTCAACTCTC
mtDNA_HhaI_Pr1	agcccacttcttaccacaagg	mtDNA_HhaI_Pr1 agcccacttcttaccacaagg
LTR3_1	AGCCGCCTAGCATTTCATCAC	LTR3_1 5'-AGCCGCCTAGCATTTCATCAC
Seq_CtIP_3	AGCCGTAAGGCCTCAGATGG	Seq_CtIP_3      5' AGCCGTAAGGCCTCAGATGG 3'
D3S2398F	AGCCTGAGCAAAACAGTGAA	D3S2398F    AGCCTGAGCAAAACAGTGAA
Human-Nestin:	AGCGTTGGAACAGAGGTTGGA	Human-Nestin:                F: 5 AGCGTTGGAACAGAGGTTGGA
Human-Nestin:	AGCGTTGGAACAGAGGTTGGA	Human-Nestin:          F: 5' AGCGTTGGAACAGAGGTTGGA
Human-Nestin:	AGCGTTGGAACAGAGGTTGGA	Human-Nestin:              F: 5 AGCGTTGGAACAGAGGTTGGA
tlRGS515	AGCTCGAGTCTAGAGCGGCCAACTTGT	tlRGS515 : AGCTCGAGTCTAGAGCGGCCAACTTGT
4th	AGCTGTGGCAAAACCCAGAT	4th peak_r4   5' AGCTGTGGCAAAACCCAGAT 3'
BAC_Smcx_	AGCTTCAGGAGTGGGTAGCA	BAC_Smcx_ 6   AGCTTCAGGAGTGGGTAGCA
cc-MycF	agcttcccagtgttcctctc	cc-MycF agcttcccagtgttcctctc
Smcx_Pr4	AGCTTGCCCAACCTTCCTAC	Smcx_Pr4 5'-AGCTTGCCCAACCTTCCTAC
Gm3-F	AGGAAACTTCCTGTGCAACC	Gm3-F    5' - AGGAAACTTCCTGTGCAACC - 3'            (20)
Gm3-F	AGGAAACTTCCTGTGCAACC	Gm3-F   5' -  AGGAAACTTCCTGTGCAACC -
Csn1s1-mid-F	AGGACAAAGGGGGTAGTTATGG	Csn1s1-mid-F      5' AGGACAAAGGGGGTAGTTATGG 3'
P1R_F2:	AGGACAATAGCGAGTAG	P1R_F2: 5' AGGACAATAGCGAGTAG 3'
mCNTN5-RT-4_R	AGGACTGAGCACGCGAGCAT	mCNTN5-RT-4_R      5' AGGACTGAGCACGCGAGCAT 3'
D3S2418R	AGGACTGTAGGATTCCAAAGG	D3S2418R    AGGACTGTAGGATTCCAAAGG
CNTN6_Ex19D_R	AGGAGCTATTGCGAAGTCCA	CNTN6_Ex19D_R  AGGAGCTATTGCGAAGTCCA
Afp	AGGAGGAGTGCTTCCAGACA	Afp f  AGGAGGAGTGCTTCCAGACA
hART3-RT-F	AGGAGGGGGCTGGCAATAACCT	hART3-RT-F      5' AGGAGGGGGCTGGCAATAACCT 3'
1st	AGGATTCTGTCCCAAATGGTGA	1st peak check f5 5' AGGATTCTGTCCCAAATGGTGA 3'
q-aSpromF	AGGCAAGAACAATGGAGTGG	q-aSpromF   5' AGGCAAGAACAATGGAGTGG 3'
mEos2_32:	AGGCTTGCCTGTACCATCTC	mEos2_32:           AGGCTTGCCTGTACCATCTC
mEos2_32:	AGGCTTGCCTGTACCATCTC	mEos2_32:         AGGCTTGCCTGTACCATCTC
Nestin_OlyaR:	AGGGAAGTTGGGCTCAGGACTGG	Nestin_OlyaR: AGGGAAGTTGGGCTCAGGACTGG
Nestin_OlyaR	AGGGAAGTTGGGCTCAGGACTGG	Nestin_OlyaR       AGGGAAGTTGGGCTCAGGACTGG
qpcr_WPRE_R:	AGGGACGTAGCAGAAGGACG	qpcr_WPRE_R: AGGGACGTAGCAGAAGGACG
D3S2459R	AGGGACTTAGAAAGATAGCAGG	D3S2459R    AGGGACTTAGAAAGATAGCAGG
3'-innT-6421	AGGGCAATCTCAAATTGAAGGCACTCTT	3'-innT-6421            AGGGCAATCTCAAATTGAAGGCACTCTT
Tub/Tomato-4073:5'	AGGGGCTGAGGTCTGTTTCT	Tub/Tomato-4073:5' - AGGGGCTGAGGTCTGTTTCT -
Seq_OG2prom	aggggtgagaggaccttgaaggt	Seq_OG2prom      5'-aggggtgagaggaccttgaaggt-3'
1st	AGGGTCAAGTGGTACCGCTA	1st peak check 3R 5' AGGGTCAAGTGGTACCGCTA 3'
Nanog_Takahashi_F:	AGGGTCTGCTACTGAGATGCTCTG	Nanog_Takahashi_F:  AGGGTCTGCTACTGAGATGCTCTG
T4adaptor_down:	aggtacacatgttGACACAAGACAGGgacagctgtcGTGTGCCTGCGaattcgagtct	T4adaptor_down:  > 5'-aggtacacatgttGACACAAGACAGGgacagctgtcGTGTGCCTGCGaattcgagtct-3'
mGapdhF:	AGGTCGGTGTGAACGGATTTG	mGapdhF: AGGTCGGTGTGAACGGATTTG
q-mGapdhF	AGGTCGGTGTGAACGGATTTG	q-mGapdhF   AGGTCGGTGTGAACGGATTTG       21b
3C_BAC183_F4	AGGTGACTCCTTGAGCCTGA	3C_BAC183_F4 5'-AGGTGACTCCTTGAGCCTGA-3'
18_T	AGGTGGCTGTTGGGTAGGG	18_T 1-2_F: AGGTGGCTGTTGGGTAGGG
1_hCNTN6_ex4_51:	AGGTGTGGTGCTTCTCTGTG	1_hCNTN6_ex4_51: AGGTGTGGTGCTTCTCTGTG
29-Brach	AGTCCCTCTCAGGTGCG	29-Brach F: AGTCCCTCTCAGGTGCG
Ttr	AGTCCTGGATGCTGTCCGAG	Ttr F AGTCCTGGATGCTGTCCGAG
c-kit_sse9i_check_F	AGTGCCCTCCACTCTGTAGC	c-kit_sse9i_check_F 5'-AGTGCCCTCCACTCTGTAGC
2AM2	agtgggtatgatgcctgtcc	2AM2 R - agtgggtatgatgcctgtcc
mCNTN5-RT-2_R	AGTGGTACTGCTGAGCTGCC	mCNTN5-RT-2_R      5' AGTGGTACTGCTGAGCTGCC 3'
CNTN6_Ex6qPCR1_R	AGTGTAGTTGCCCACATCTGA	CNTN6_Ex6qPCR1_R    AGTGTAGTTGCCCACATCTGA
mEos_to_lego_R	AGTTATTAGGTCCCTCGACGTCAAATCCCCAGATATTGGT	mEos_to_lego_R 5'-AGTTATTAGGTCCCTCGACGTCAAATCCCCAGATATTGGT-3'
133	AGTTCTGTCCTTTCAGCTGGG	133 AGTTCTGTCCTTTCAGCTGGG
G-CSF	AGTTCTTCCATCTGCTGCCA	G-CSF RNA R: 5'- AGTTCTTCCATCTGCTGCCA -3'
EScaseinGM_3H_R	agttcttgaagggcagagtatgg	EScaseinGM_3H_R      agttcttgaagggcagagtatgg
Clon-2A-Tomato-F	agttGCTAGCgccactaacttctccctgttgaaacaagcaggggatgtcgaagagaatcccgggccaatggtgagcaagggcgagga	Clon-2A-Tomato-F      agttGCTAGCgccactaacttctccctgttgaaacaagcaggggatgtcgaagagaatcccgggccaatggtgagcaagggcgagga
114	AGTTGGAGGAAGCTGTGAGC	114 AGTTGGAGGAAGCTGTGAGC
GGTTGTTGCTGATCTGCTTCAGGACCCT	AGTTGTGCTGGTGAGTGGAG	GGTTGTTGCTGATCTGCTTCAGGACCCT    qmMycF2 AGTTGTGCTGGTGAGTGGAG
CNTN6_Ex19D_F	AGTTTGTGTTCCCTTGTTCCA	CNTN6_Ex19D_F  AGTTTGTGTTCCCTTGTTCCA
qKdrF	ATAACCTGGCTGACCCGATTC	qKdrF 5'-ATAACCTGGCTGACCCGATTC-3'
D3S2465R	ATAACTAGCTGGGTTTGGGG	D3S2465R    ATAACTAGCTGGGTTTGGGG
Primer2	ATAAGCTGCAATAAACAAGTTAGCACCGACTCGGTGCCAC	Primer2 5'-ATAAGCTGCAATAAACAAGTTAGCACCGACTCGGTGCCAC
primer2	ATAAGCTGCAATAAACAAGTTAGCACCGACTCGGTGCCAC	primer2 ATAAGCTGCAATAAACAAGTTAGCACCGACTCGGTGCCAC
hART4-RT-R	ATAAGGCAAAGGGGTACAAGGA	hART4-RT-R    5' ATAAGGCAAAGGGGTACAAGGA 3'
Inv-Skryre-end:	ATAGCCACCTTTGTTCATGGCAGCC	Inv-Skryre-end: ATAGCCACCTTTGTTCATGGCAGCC 25bp
4th	ATAGTGGGCTGGGCAAATCC	4th peak r2 5' ATAGTGGGCTGGGCAAATCC 3'
hpH34-S40	ATATCCCGCCGTGGGTGAAAGTTC	hpH34-S40 ATA TCC CGC CGT GGG TGA AAG TTC
tlCMV_32	ATATCTGGCCCGTACATCGC	tlCMV_32 : ATATCTGGCCCGTACATCGC
mCNTN5-RT-Ex7_R	ATATTTGTAGCTGTCCACGAAAGGA	mCNTN5-RT-Ex7_R      5' ATATTTGTAGCTGTCCACGAAAGGA 3'
H19_Mice_OR	ATCAAAAACTAACATAAACCCCT	H19_Mice_OR  ATCAAAAACTAACATAAACCCCT  23
5_tail_REV	ATCACCGACTGCCCATAGAGAGG	5_tail_REV 5' ATCACCGACTGCCCATAGAGAGG 3'
ZigGM3-R	ATCACTGGAGCATTCTGGCCCTTG	ZigGM3-R            ATCACTGGAGCATTCTGGCCCTTG
mMef2cR	atcatatgactagtTCATGTTGCCCATCCTTCAGA	mMef2cR 5- atcatatgactagtTCATGTTGCCCATCCTTCAGA-3
mGata4R	atcatatgactagtTTACGCGGTGATTATGTCCCC	mGata4R 5-atcatatgactagtTTACGCGGTGATTATGTCCCC-3
mTbx5R	atcatatgactagtTTAGCTATTCTCACTCCACTCTGGCAC	mTbx5R 5- atcatatgactagtTTAGCTATTCTCACTCCACTCTGGCAC-3
GFP_LegoG2_F	ATCCAGTTTGGTTAGTACCG	GFP_LegoG2_F   5' ATCCAGTTTGGTTAGTACCG 3'
3C_Anopheles_3F	ATCCGGTCAACTCGATCT	3C_Anopheles_3F   5' ATCCGGTCAACTCGATCT 3'
Clon-GMCSF-R	ATCGAATTCCACGTGTCACTCCTGGACTGGCTCCCAGCA	Clon-GMCSF-R     ATCGAATTCCACGTGTCACTCCTGGACTGGCTCCCAGCA
Clon-3short-2-R	ATCGGGCCCGCGATCGCTTGACTGCTAACTGCATTTCTAC	Clon-3short-2-R       ATCGGGCCCGCGATCGCTTGACTGCTAACTGCATTTCTAC
Clon-SV40pA-R	ATCGGTACCACGCGTGCCTTAAGATACATTGATGAGTTTGG	Clon-SV40pA-R      ATCGGTACCACGCGTGCCTTAAGATACATTGATGAGTTTGG
olig2	atctcgagGTTGTAAAACGACGGCCAGTnnnnnnnnnnnnnnnnnnnnnnnnnnnnnnGGTCATAGCTGTTTCCTGctcgagta	olig2   > 5'-atctcgagGTTGTAAAACGACGGCCAGTnnnnnnnnnnnnnnnnnnnnnnnnnnnnnnGGTCATAGCTGTTTCCTGctcgagta-3'
qmMycF	ATCTGCTTCAGGACCCT	qmMycF 5-ATCTGCTTCAGGACCCT-3
RT-mCNBD1-2-R	ATCTGTCACAACTGAACGGTCAC	RT-mCNBD1-2-R      5' ATCTGTCACAACTGAACGGTCAC 3'
GM9_1_F	ATCTTGCTTTTCGGGAGCGT	GM9_1_F  5' ATCTTGCTTTTCGGGAGCGT 3'
MS2_sg-olig_Oct4-OG2_1	atcttgtggaaaggacgaaacaccgaacctccgtctggaagacacgttttagagctaggccaacatgag	MS2_sg-olig_Oct4-OG2_1 atcttgtggaaaggacgaaacaccgaacctccgtctggaagacacgttttagagctaggccaacatgag
MS2_sg-olig_Oct4-OG2_2	atcttgtggaaaggacgaaacaccgcaaggctagagggtgggattgttttagagctaggccaacatgag	MS2_sg-olig_Oct4-OG2_2 atcttgtggaaaggacgaaacaccgcaaggctagagggtgggattgttttagagctaggccaacatgag
MS2_sg-olig_Csn1S1_1	atcttgtggaaaggacgaaacaccggaatttcccaggagaggtatgttttagagctaggccaacatgag	MS2_sg-olig_Csn1S1_1 atcttgtggaaaggacgaaacaccggaatttcccaggagaggtatgttttagagctaggccaacatgag
MS2_sg-olig_Csn1S1_2	atcttgtggaaaggacgaaacaccgtcagtgagtttaaatagtcagttttagagctaggccaacatgag	MS2_sg-olig_Csn1S1_2 atcttgtggaaaggacgaaacaccgtcagtgagtttaaatagtcagttttagagctaggccaacatgag
R:5'	ATGAAACTGTCTCTAGTGTG	R:5' - ATGAAACTGTCTCTAGTGTG -
45_bottom	ATGAAGAGTAGCCTAGCAGGAGGt	45_bottom 5'-ATGAAGAGTAGCCTAGCAGGAGGt-3'
PuroCsonka2000F	ATGACCGAGTACAAGCCCACGGTGCGC	PuroCsonka2000F primer 5'-ATGACCGAGTACAAGCCCACGGTGCGC
D3S3045R	ATGAGGACGGTTGACATCTG	D3S3045R    ATGAGGACGGTTGACATCTG
hECAT15-2-AS667	ATGATGCCAACATGGCTCCCGGTG	hECAT15-2-AS667 ATG ATG CCA ACA TGG CTC CCG GTG
chic3	ATGATGGTGGGTGCCATATT	chic3 5'-ATGATGGTGGGTGCCATATT-3'
D3S2436R	ATGCCCATCAATCAATGAGT	D3S2436R    ATGCCCATCAATCAATGAGT
qpcr_GFP_R	ATGCCCTTCAGCTCGATGC	qpcr_GFP_R : ATGCCCTTCAGCTCGATGC
140	ATGCTATAGGGGCAACTCCAT	140 ATGCTATAGGGGCAACTCCAT
GSCF	ATGCTGCCCTACATGAACGT	GSCF 5'-ATGCTGCCCTACATGAACGT-3'
Aat	ATGGACAGTCTGGGGAAGTG	Aat R ATGGACAGTCTGGGGAAGTG
51:00:00	ATGGAGAGCTCTGGCAAGATGGAGAGT	51: ATGGAGAGCTCTGGCAAGATGGAGAGT
135	ATGGCAGTGGGGTCTGAATG	135 ATGGCAGTGGGGTCTGAATG
EScaseinGM_5H_OUT_R	ATGGCATTCACATGCTCCCA	EScaseinGM_5H_OUT_R      ATGGCATTCACATGCTCCCA
Tbx5-Inner-F	ATGGCCGATACAGATGAGGGCTTTG	Tbx5-Inner-F : 5-ATGGCCGATACAGATGAGGGCTTTG-3
hPAX6-AS1497	ATGGTGAAGCTGGGCATAGGCGGCAG	hPAX6-AS1497   ATG GTG AAG CTG GGC ATA GGC GGC AG
mGata4-innerF	ATGTACCAAAGCCTGGCCATGGC	mGata4-innerF : 5-ATGTACCAAAGCCTGGCCATGGC-3
Barc_concat_F	ATGTACCTGCAGGNNCGANNGCANNTGCNNCTTGAATGACAACTAGTGCTCCAGG	Barc_concat_F    5' ATGTACCTGCAGGNNCGANNGCANNTGCNNCTTGAATGACAACTAGTGCTCCAGG 3'
Concat-bc-F	ATGTATTCGAANNCGANNGCANNTGCNNCTTGAATGACAACTAGTGCTCCAGG	Concat-bc-F    5' ATGTATTCGAANNCGANNGCANNTGCNNCTTGAATGACAACTAGTGCTCCAGG 3'
GMCSF-F-gibson	atgtggctgcagagcctgct	GMCSF-F-gibson          5'-atgtggctgcagagcctgct-3'
GMCSF-F-gibson	atgtggctgcagagcctgct	GMCSF-F-gibson                  5'-atgtggctgcagagcctgct-3'
GMCSF-F-gibson	atgtggctgcagagcctgct	GMCSF-F-gibson              5'-atgtggctgcagagcctgct-3'
GMCSF-F-gibson	atgtggctgcagagcctgct	GMCSF-F-gibson    5'-atgtggctgcagagcctgct-3'
TAF4_dupOUT1_F	ATGTTTAGGGACGGGAAGCC	TAF4_dupOUT1_F     ATGTTTAGGGACGGGAAGCC
qNvSox2R	ATTACCAACGAAGTCAACCT	qNvSox2R    ATTACCAACGAAGTCAACCT
bsCMV31	ATTCACTAAACCAACTCTACTTATATAAAC	bsCMV31 : 5-ATTCACTAAACCAACTCTACTTATATAAAC-3
D3S3050R	ATTCCCTGACTTCAAGTGCA	D3S3050R    ATTCCCTGACTTCAAGTGCA
Mef2BudF	attcctgcaggtcaccATGGGGAGAAAAAAGATTCAGATT	Mef2BudF : 5-attcctgcaggtcaccATGGGGAGAAAAAAGATTCAGATT-3
VASA_F_Schatten	ATTCTTGGAAGTCAGAAGCAGAAG	VASA_F_Schatten     ATTCTTGGAAGTCAGAAGCAGAAG
qmMycR2	ATTGATGTGGTGTCTGTGGAG	qmMycR2 ATTGATGTGGTGTCTGTGGAG
139	ATTGCATAGATGTGCGGGGG	139 ATTGCATAGATGTGCGGGGG
D3S2460F	ATTGCTTCCCCTTTACCTGA	D3S2460F    ATTGCTTCCCCTTTACCTGA
qRianR	ATTGGAAGTCTGAGCCATGG	qRianR ATTGGAAGTCTGAGCCATGG
CNTN6_Ex4D_R	ATTGGAGCTTTGCCTTCCGA	CNTN6_Ex4D_R    ATTGGAGCTTTGCCTTCCGA
hCNTN6i23_31	ATTTCTAGTTCTGAGGTAACATTCT	hCNTN6i23_31 : ATTTCTAGTTCTGAGGTAACATTCT
Hygr_R	ATTTGTGTACGCCCGACAGT	Hygr_R  5' ATTTGTGTACGCCCGACAGT 3'
07_bottom	ATTTTCATGGGGATGCAAGGTGGt	07_bottom 5'-ATTTTCATGGGGATGCAAGGTGGt-3'
bsIG-DMR-r1	CAAAACATTCTCCATTAACAAAATAATACAACCCT	bsIG-DMR-r1    5'-CAAAACATTCTCCATTAACAAAATAATACAACCCT-3'
q-gmF	CAAAGGGGATGACAAGCAGA	q-gmF CAAAGGGGATGACAAGCAGA 20
Ddx3x_Pr4	CAAATGCATACTCCGGTGCG	Ddx3x_Pr4 5'-CAAATGCATACTCCGGTGCG
104	CAACAGGATCCAGGTTCCCC	104         CAACAGGATCCAGGTTCCCC
Nanog_Takahashi_R:	CAACCACTGGTTTTTCTGCCACCG	Nanog_Takahashi_R:  CAACCACTGGTTTTTCTGCCACCG
3C-F18_+6	CAACCTGAGAAGCCAAGCCAA	3C-F18_+6    CAACCTGAGAAGCCAAGCCAA
P1R_R2:	CAACTTTGTAcAAaAAAGTTGAAC	P1R_R2: 5' CAACTTTGTAcAAaAAAGTTGAAC 3'
P4_R2:	CAACTTTGTAtAgaAAAGTTGAAC	P4_R2:  5' CAACTTTGTAtAgaAAAGTTGAAC 3'
D4Mit203R	CAAGAGCCCAGGTGTGGTAT	D4Mit203R  CAAGAGCCCAGGTGTGGTAT
GCTTTCCTGACCCCAAGCTG	CAAGGGTATTAGGCAAGGGGG	GCTTTCCTGACCCCAAGCTG    Nestin.R: CAAGGGTATTAGGCAAGGGGG
3-GM20-conf	CAAGGTGTCAAAGTGTCCTCCCTA	3-GM20-conf CAAGGTGTCAAAGTGTCCTCCCTA
tltkpA_52	CAATACGCCCGCGTTTCTTC	tltkpA_52 : CAATACGCCCGCGTTTCTTC
TKA_pA34	CAATGGGGTCTCGGTGGG	TKA_pA34 : CAATGGGGTCTCGGTGGG
CNTN6_Ex18qPCR1_R	CAATGGTCACAGTACTCAGGGA	CNTN6_Ex18qPCR1_R    CAATGGTCACAGTACTCAGGGA
36_g1chr15cut1LF	CAATTAGCGAGGCAGGCCTAG	36_g1chr15cut1LF    CAATTAGCGAGGCAGGCCTAG
Tph2Int12_51:	caattgagtcgatggcgcgccTGGACACCTGCTGTAGAGTAA	Tph2Int12_51: caattgagtcgatggcgcgccTGGACACCTGCTGTAGAGTAA
SOX1_Mel_For	CACAACTCGGAGATCAGCAA	SOX1_Mel_For    CACAACTCGGAGATCAGCAA
BBB_f	CACAAGAGGAGGAGGAGGTG	BBB_f 5'-CACAAGAGGAGGAGGAGGTG-3'
D18Mit184F	CACACATGTGTAGGTAGGTAGGTAGG	D18Mit184F  CACACATGTGTAGGTAGGTAGGTAGG
SOX-Low:	CACACCGGCGCGCCATTTCTCCCCCCTCCAGTTCG	SOX-Low: 5' -  CACACCGGCGCGCCATTTCTCCCCCCTCCAGTTCG
D3S2403R	CACACTCAAAATACATGAAGGC	D3S2403R    CACACTCAAAATACATGAAGGC
OCT4_Mel_Rev	CACAGAACTCATACGGCGGG	OCT4_Mel_Rev   CACAGAACTCATACGGCGGG
Kdr_97_CheckPrimer_F	CACAGTGACACACCCACCTC	Kdr_97_CheckPrimer_F    5' CACAGTGACACACCCACCTC 3'
qNvHprtR	CACCAATGACTTTGATGTCCC	qNvHprtR      CACCAATGACTTTGATGTCCC
Kdr_dr-gfp_bottom	CACCAGTCATGAACAAATCGTGGCA	Kdr_dr-gfp_bottom 5-CACCAGTCATGAACAAATCGTGGCA-3
CNTN6_Ex2D_R	CACCCATAGAAAGAAATACAATGCC	CNTN6_Ex2D_R    CACCCATAGAAAGAAATACAATGCC
mCNTN5-RT_F	cacccctcttgccgcagagc	mCNTN5-RT_F      5'-cacccctcttgccgcagagc-3'
VPR-sg-olig_Oct4-OG2_1_UP	CACCGaacctccgtctggaagacacGTT	VPR-sg-olig_Oct4-OG2_1_UP     5'-CACCGaacctccgtctggaagacacGTT-3'
hHPRT_BsmbI_F1	CACCGAAGTAATTCACTTACAGTCGTT	hHPRT_BsmbI_F1 CACCG AAGTAATTCACTTACAGTC GTT
gInsBB_15F:	CACCGAATGAGGTTGCTATGGAAAC	gInsBB_15F: CACCG AATGA GGTTG CTATG GAAAC
gRNA_AAVS_1	CACCGACCCCACAGTGGGGCCACTAGTT	gRNA_AAVS_1    5'- CACCGACCCCACAGTGGGGCCACTAGTT-
gRNA_Rosa26_F	CACCGACTCCAGTCTTTCTAGAAGAGTT	gRNA_Rosa26_F    5'- CACCGACTCCAGTCTTTCTAGAAGAGTT -
5_gRNA_Rosa_1F:	CACCGACTGGAGTTGCAGATCACGAGTT	5_gRNA_Rosa_1F: CACCG ACTGGAGTTGCAGATCACGA GTT
50_51_gRNA_CNTN6_end_Clon_vect	caccgACTGGTATCATCCTGTCCTG	50_51_gRNA_CNTN6_end_Clon_vect             5 caccgACTGGTATCATCCTGTCCTG 3
50_51_gRNA_CNTN6_end_Clon_vect	caccgACTGGTATCATCCTGTCCTG	50_51_gRNA_CNTN6_end_Clon_vect         5 caccgACTGGTATCATCCTGTCCTG 3
sg-olig_Csn1s1_KO3_UP	CACCGatactgaaaaaaccaatgtgGTT	sg-olig_Csn1s1_KO3_UP    5'-CACCGatactgaaaaaaccaatgtgGTT-3'
48_51_gRNA_CNTN6_start_Clon_vect	caccgATCGACAACACAATCCCGGA	48_51_gRNA_CNTN6_start_Clon_vect         5 caccgATCGACAACACAATCCCGGA 3
45_top	caccgATGAAGAGTAGCCTAGCAGGgtt	45_top 5'-caccgATGAAGAGTAGCCTAGCAGGgtt-3'
07_top	caccgATTTTCATGGGGATGCAAGGgtt	07_top 5'-caccgATTTTCATGGGGATGCAAGGgtt-3'
VPR-sg-olig_Oct4-OG2_2_UP	CACCGcaaggctagagggtgggattGTT	VPR-sg-olig_Oct4-OG2_2_UP    5'-CACCGcaaggctagagggtgggattGTT-3'
9_gRNA_T_2F:	CACCGCACTCGCAGTTCGCGTTCGGGTT	9_gRNA_T_2F: 5- CACCG CACTCGCAGTTCGCGTTCGG GTT-
gRNA_hART4_Ex1_2_UP	CACCGCAGATTCTCATCGTTGCAGGGTT	gRNA_hART4_Ex1_2_UP                 5'-CACCGCAGATTCTCATCGTTGCAGGGTT-3'
CNTN6_Ex6qPCR1_F	CACCGCCACATTTTGGAGATTT	CNTN6_Ex6qPCR1_F    CACCGCCACATTTTGGAGATTT
gInsBB_13F:	CACCGCCACTCATAAACTCTTCTGC	gInsBB_13F: CACCG CCACT CATAA ACTCT TCTGC
gIns-Brach-F1:	CACCGCCTTTTTCTTGGAAAAGCGGGTT	gIns-Brach-F1: CACCG CCTTTTTCTTGGAAAAGCGG GTT
gRNA_hART5_Ex2_1_UP	CACCGCTCCTCTGCACAACCCACATGTT	gRNA_hART5_Ex2_1_UP           5'-CACCGCTCCTCTGCACAACCCACATGTT-3'
27_top	caccgCTTAATAGACGAAGGTCATGgtt	27_top 5'-caccgCTTAATAGACGAAGGTCATGgtt-3'
40004_top	caccgGAAGACAGGAAACTTACCGAgtt	40004_top 5'-caccgGAAGACAGGAAACTTACCGAgtt-3'
3_gRNA_Rosa_2F:	CACCGGAAGATGGGCGGGAGTCTTCGTT	3_gRNA_Rosa_2F: CACCG GAAGATGGGCGGGAGTCTTC GTT
VPR_sg-olig_Csn1S1_1_UP	CACCGgaatttcccaggagaggtatGTT	VPR_sg-olig_Csn1S1_1_UP     5'-CACCGgaatttcccaggagaggtatGTT-3'
30001_top	caccgGACCAGCGAAAACCTTGCCGgtt	30001_top 5'-caccgGACCAGCGAAAACCTTGCCGgtt-3'
gRNA_kdr_4_peak	caccgGAGGTAAGAGCAATCCGGTAgtt	gRNA_kdr_4_peak 88.1 0 0 0 0_top   5' caccgGAGGTAAGAGCAATCCGGTAgtt 3'
52_52_gRNA_CNTN6_start_Clon_vect	caccgGCAGGCGATAATATTGAGAG	52_52_gRNA_CNTN6_start_Clon_vect             5 caccgGCAGGCGATAATATTGAGAG 3
52_52_gRNA_CNTN6_start_Clon_vect	caccgGCAGGCGATAATATTGAGAG	52_52_gRNA_CNTN6_start_Clon_vect         5 caccgGCAGGCGATAATATTGAGAG 3
40002_top	caccgGCGCCGTAAGTGCTGAAAAGgtt	40002_top 5'-caccgGCGCCGTAAGTGCTGAAAAGgtt-3'
mtDNA_Pr10	caccggcgtcaaagtatttagc	mtDNA_Pr10 caccggcgtcaaagtatttagc
gRNA_kdr_4_peak	caccgGCTGTCCAGGCACCACTCCAgtt	gRNA_kdr_4_peak 97.5 0 0 2 7_top   5' caccgGCTGTCCAGGCACCACTCCAgtt 3'
gIns-Brach-F2:	CACCGGGCAGGGGGTGCGGCGGATTGTT	gIns-Brach-F2: CACCG GGCAGGGGGTGCGGCGGATT GTT
2_top	caccgGGTAGACCCCTCCTCCACAGgtt	2_top 5'-caccgGGTAGACCCCTCCTCCACAGgtt-3'
4_top	caccgGGTCAAAGGTGGGTAGCTAGgtt	4_top 5'-caccgGGTCAAAGGTGGGTAGCTAGgtt-3'
gRNA_hART5_Ex2_2_UP	CACCGGGTGTCTGGAGCCAGGCCCAGTT	gRNA_hART5_Ex2_2_UP           5'-CACCGGGTGTCTGGAGCCAGGCCCAGTT-3'
MS2_sg-olig_Csn1S1_3_UP	CACCGGTGGGTTTTGTTTCTGACAA	MS2_sg-olig_Csn1S1_3_UP      5'-CACCGGTGGGTTTTGTTTCTGACAA-3'
VPR_sg-olig_Csn1S1_3_UP	CACCGGTGGGTTTTGTTTCTGACAAGTT	VPR_sg-olig_Csn1S1_3_UP     5'-CACCGGTGGGTTTTGTTTCTGACAAGTT-3'
27_gRNA_3-2-F:	CACCGGTTGGCCAAAACAATAACCGGTT	27_gRNA_3-2-F: CACC G GTTGGCCAAAACAATAACCG GTT
71_top	caccgTAATGGCACGGAACACAGGAgtt	71_top 5'-caccgTAATGGCACGGAACACAGGAgtt-3'
sg-olig_Csn1s1_ATG3_UP	CACCGtagcaaaagcagcagccacgGTT	sg-olig_Csn1s1_ATG3_UP     5'-CACCGtagcaaaagcagcagccacgGTT-3'
VPR_sg-olig_Csn1S1_2_UP	CACCGtcagtgagtttaaatagtcaGTT	VPR_sg-olig_Csn1S1_2_UP     5'-CACCGtcagtgagtttaaatagtcaGTT-3'
gRNA_hART4_Ex1_1_UP	CACCGTGGCCTGCAGAGACCCACAGGTT	gRNA_hART4_Ex1_1_UP           5'-CACCGTGGCCTGCAGAGACCCACAGGTT-3'
7_gRNA_T_1F:	CACCGTGGCGGGAGGATGAGCTCGCGTT	7_gRNA_T_1F:  5- CACCG TGGCGGGAGGATGAGCTCGC GTT-
25_gRNA_3-1-F:	CACCGTGTCTGCCCATAGGGTGGGGGTT	25_gRNA_3-1-F: CACC G TGTCTGCCCATAGGGTGGGG GTT
gIns-Brach-F3:	CACCGTGTGCGCTTGGACAGCGCGTGTT	gIns-Brach-F3: CACCG TGTGCGCTTGGACAGCGCGT GTT
23_gRNA_1-1-F:	CACCGTGTGGAAAACCAAGAAGCCCGTT	23_gRNA_1-1-F: CACC G TGTGGAAAACCAAGAAGCCC GTT
F:5'-GTGGGAAACGTGACCAAACC-3'	CACGACCATCTTGCCATCCT	F:5'-GTGGGAAACGTGACCAAACC-3'    Blbp.R:5'-CACGACCATCTTGCCATCCT-3'
F:5'-GTGGGAAACGTGACCAAACC-3'	CACGACCATCTTGCCATCCT	F:5'-GTGGGAAACGTGACCAAACC-3'        Blbp.R:5'-CACGACCATCTTGCCATCCT-3'
qpBudZeoRF	CACGACCTCCGACCACTCG	qpBudZeoRF   CACGACCTCCGACCACTCG   19b
qpBudZeoRF	CACGACCTCCGACCACTCG	qpBudZeoRF CACGACCTCCGACCACTCG 19b
FLK1_Mel_Rev	CACGACTCCATGTTGGTCAC	FLK1_Mel_Rev   CACGACTCCATGTTGGTCAC
MAP2_Mel_Rev	CACGCTGGATCTGCCTGGGGACTGTG	MAP2_Mel_Rev    CACGCTGGATCTGCCTGGGGACTGTG
PrF_gc-kit2_PciI	cacgtgacatgtGAAGAGGGCCTATTTC	PrF_gc-kit2_PciI cacgtgacatgtGAAGAGGGCCTATTTC
tgfbr3_up_check_F	CACGTGGGGAGTCATCCTTG	tgfbr3_up_check_F 5' CACGTGGGGAGTCATCCTTG 3'
2nd	CACTCCAAATGCAGAGGACA	2nd peak F 5' CACTCCAAATGCAGAGGACA 3'
CNTN6_Ex5D_R	CACTCTCCAAGTGACCGCAT	CNTN6_Ex5D_R    CACTCTCCAAGTGACCGCAT
GM_RNA_L	CACTGCTGCTGAGATGAATGAAA	GM_RNA_L CACTGCTGCTGAGATGAATGAAA 23
D3S1768R	CACTGTGATTTGCTGTTGGA	D3S1768R    CACTGTGATTTGCTGTTGGA
SOX17_Mel_Rev	CAGAATCCAGACCTGCACAA	SOX17_Mel_Rev   CAGAATCCAGACCTGCACAA
5'-ctagctagcggatccactgtctagagaattctg-3'	cagaattctctagacagtggatccgctagctag	5'-ctagctagcggatccactgtctagagaattctg-3'  > LeGO.R: 5'-cagaattctctagacagtggatccgctagctag-3'
MycoRomoR:	CAGACCCAAGGCAT	MycoRomoR: CTTCWTCGACTTYCAGACCCAAGGCAT
Tub/Tomato-5644:5'	CAGACTTGCTCCGCATTGT	Tub/Tomato-5644:5' - CAGACTTGCTCCGCATTGT -
GM9_2_R	CAGAGACCAGTCTGCACAGG	GM9_2_R  5' CAGAGACCAGTCTGCACAGG 3'
Aat	CAGAGGAGGCCAAGAAAGTG	Aat F CAGAGGAGGCCAAGAAAGTG
CNTN6_Ex6D_F	CAGATATGAATGAATGCAGTAAGGA	CNTN6_Ex6D_F    CAGATATGAATGAATGCAGTAAGGA
hREX1-RT-U	CAGATCCTAAACAGCTCGCAGAAT	hREX1-RT-U CAG ATC CTA AAC AGC TCG CAG AAT
Gibson_Cas9_R	cagatcctcctcctccgctgccgccgccgccgctgccgccgccgccCACCTTCCTCTTCTTCTTGGGGTCAG	Gibson_Cas9_R    cagatcctcctcctccgctgccgccgccgccgctgccgccgccgccCACCTTCCTCTTCTTCTTGGGGTCAG
CNTN6_Del2_R	CAGCACCAATGGGAAATGTGT	CNTN6_Del2_R    5`-CAGCACCAATGGGAAATGTGT-3`
Sry_Tojo_F:	CAGCCCTACAGCCACATGATACTT	Sry_Tojo_F:  CAGCCCTACAGCCACATGATACTT
mtDNA_HhaI_Pr3	cagccctactccactcaagc	mtDNA_HhaI_Pr3 cagccctactccactcaagc
Ins-FRC	cagcctctgttccacatacact	Ins-FRC      5'-cagcctctgttccacatacact-3'
Foxa2_OlyaR	CAGCGCCCACATAGGATGAC	Foxa2_OlyaR       CAGCGCCCACATAGGATGAC
Foxa2_OlyaR:	CAGCGCCCACATAGGATGAC	Foxa2_OlyaR: CAGCGCCCACATAGGATGAC
Foxa2	CAGCGCCCACATAGGATGAC	Foxa2 R: CAGCGCCCACATAGGATGAC
110	CAGCGCTGAATAGTCCCGAT	110         CAGCGCTGAATAGTCCCGAT
Nestin_OlyaF:	CAGCTGGCGCACCTAAGATG	Nestin_OlyaF: CAGCTGGCGCACCTAAGATG
Nestin_OlyaF	CAGCTGGCGCACCTAAGATG	Nestin_OlyaF       CAGCTGGCGCACCTAAGATG
M13R	CAGGAAACAGCTATGAC	M13R CAGGAAACAGCTATGAC
M13_R:	CAGGAAACAGCTATGAC	M13_R:  5'  CAGGAAACAGCTATGAC  3'
CDC7_down_check_F:	CAGGAGAGCAAGGGTAGCAG	CDC7_down_check_F: 5' CAGGAGAGCAAGGGTAGCAG 3'
CDC7_down_check_R:	CAGGAGAGCAAGGGTAGCAG	CDC7_down_check_R: 5' CAGGAGAGCAAGGGTAGCAG 3'
3'-oTg-redeemer	CAGGCAAGAACAATGGAGTGGGTTGCC	3'-oTg-redeemer = CAGGCAAGAACAATGGAGTGGGTTGCC
3'-iTg-redeemer	CAGGCAGGTTCTTTACCACTAGTGCCA	3'-iTg-redeemer = CAGGCAGGTTCTTTACCACTAGTGCCA
GM9_1_R	CAGGCCTTCATCTTCAGCCA	GM9_1_R  5' CAGGCCTTCATCTTCAGCCA 3'
Cas9check-R	CAGGGTAATCACAAAGGCAATGA	Cas9check-R      5' CAGGGTAATCACAAAGGCAATGA 3'
MAP2_Mel_For	CAGGTGGCGGACGTGTGAAAATTGAGAGTG	MAP2_Mel_For    CAGGTGGCGGACGTGTGAAAATTGAGAGTG
GSCR	CAGTCCTGGGCCTGTACATT	GSCR 5'-CAGTCCTGGGCCTGTACATT-3'
ATGCTGCCCTACATGAACGT	CAGTCCTGGGCCTGTACATT	ATGCTGCCCTACATGAACGT                  R CAGTCCTGGGCCTGTACATT
ATGCTGCCCTACATGAACGT	CAGTCCTGGGCCTGTACATT	ATGCTGCCCTACATGAACGT  >> R CAGTCCTGGGCCTGTACATT
ATGCTGCCCTACATGAACGT	CAGTCCTGGGCCTGTACATT	ATGCTGCCCTACATGAACGT  >>>> R CAGTCCTGGGCCTGTACATT
D9S768R:	CAGTCTTGCCCGTTATTTAC	D9S768R:  CAGTCTTGCCCGTTATTTAC
4C_primer	CAGTGAACAAATGCAGAAGGTG	4C_primer 3_R  5' CAGTGAACAAATGCAGAAGGTG 3'
D15S642F:	CAGTTACCCAGGAAGCTGAA	D15S642F:  CAGTTACCCAGGAAGCTGAA
mCNTN5-RT_R	cagttcgaaggagggcggcg	mCNTN5-RT_R      5'-cagttcgaaggagggcggcg-3'
mEos_31	CATCATCATTGCGGGCTGCATCCCACCTCCACCTC	mEos_31 : CATCATCATTGCGGG CTGCATCCCACCTCCACCTC
Alb	CATCCTTGGCCTCAGCATAG	Alb R CATCCTTGGCCTCAGCATAG
TAGCCAGGTTGCGAAGAACT	CATCTCTGATCTCGACTGC	TAGCCAGGTTGCGAAGAACT    Neurod1 F  CATCTCTGATCTCGACTGC
Neurod1	CATCTCTGATCTCGACTGC	Neurod1 F CATCTCTGATCTCGACTGC
D3S3038F	CATCTTTCTTTTCCTGTTCCC	D3S3038F    CATCTTTCTTTTCCTGTTCCC
4C_primer	CATGCACTCATGGCAAGCTT	4C_primer 6_F  5' CATGCACTCATGGCAAGCTT 3'
5'-GGCGAGGAGGTCATCAAAGA-3'	CATGCCGTACAGGAACAGGT	5'-GGCGAGGAGGTCATCAAAGA-3'  > Tomato.R: 5'-CATGCCGTACAGGAACAGGT-3'
Clover-Adapter-DOWN	CATGCCTGCAGGAGCATCTTGCTAGC	Clover-Adapter-DOWN    5'-CATGCCTGCAGGAGCATCTTGCTAGC-3'
Morrslieb-R:	CATGGACTTTAGCCTGCCAGTCTC	Morrslieb-R:     5'-CATGGACTTTAGCCTGCCAGTCTC-3'
Morrslieb-R:	CATGGACTTTAGCCTGCCAGTCTC	Morrslieb-R:         5'-CATGGACTTTAGCCTGCCAGTCTC-3'
promTRE_BamHINheIR	catGGATCCGCTAGCgaattcggggccgcgg	promTRE_BamHINheIR 5'-catGGATCCGCTAGCgaattcggggccgcgg-3'
noEcoRI_TRE_BamHINheIR	catGGATCCGCTAGCtcattcggggccgcgggc	noEcoRI_TRE_BamHINheIR 5'-catGGATCCGCTAGCtcattcggggccgcgggc-3'
Clover-Adapter-UP	CATGGCTAGCAAGATGCTCCTGCAGG	Clover-Adapter-UP    5'-CATGGCTAGCAAGATGCTCCTGCAGG-3'
Barcode	catgtaacatgtCAGGAAACAGCTATGACC	Barcode olig (EcoRI-PciI)2ex 5'-catgtaacatgtCAGGAAACAGCTATGACC-3'
Brachyury_OlyaF:	CATGTACTCTTCTTGCTGG	Brachyury_OlyaF: CATGTACTCTTCTTGCTGG
1ex	catgtatgaattcGTTGTAAAACGACGGCCAGTnnnnnnnnnnnnnnnnnnnnnnnnnnnnnnGGTCATAGCTGTTTCCTGacatgtta	1ex  >> 5'-catgtatgaattcGTTGTAAAACGACGGCCAGTnnnnnnnnnnnnnnnnnnnnnnnnnnnnnnGGTCATAGCTGTTTCCTGacatgtta-3
1ex	catgtatgaattcGTTGTAAAACGACGGCCAGTnnnnnnnnnnnnnnnnnnnnnnnnnnnnnnGGTCATAGCTGTTTCCTGacatgtta	1ex  > 5'-catgtatgaattcGTTGTAAAACGACGGCCAGTnnnnnnnnnnnnnnnnnnnnnnnnnnnnnnGGTCATAGCTGTTTCCTGacatgtta-3
31:00:00	CATGTTAGCAGACTTCCTCTGCCCTCGAACCAGTTGGTAAAGTCCAGCAGCTCT	31: CATGTTAGCAGACTTCCTCTGCCCTCGAACCAGTTGGTAAAGTCCAGCAGCTCT
D10Mit104R:	CATTATTCAAAAGATCTGTGGACG	D10Mit104R: 5'-CATTATTCAAAAGATCTGTGGACG
D10Mit104R2:	CATTATTCAAAAGATCTGTGGACG	D10Mit104R2: 5'-CATTATTCAAAAGATCTGTGGACG
3'uoTg	CATTATTCCATTGGAAGGAATTTAC	3'uoTg      5'-CATTATTCCATTGGAAGGAATTTAC-3'
137	CCAAACCTGAGTCCTCGTGA	137 CCAAACCTGAGTCCTCGTGA
120	CCAAGACCTTCCCTTCCACT	120 CCAAGACCTTCCCTTCCACT
mCNTN5-RT-Ex5_R	CCAAGTGCAAAGCATTCCATCT	mCNTN5-RT-Ex5_R      5' CCAAGTGCAAAGCATTCCATCT 3'
SOX-Up:	CCACACGTTTAAACcaccatgtacaacatgatggagacg	SOX-Up: 5' -  CCACACGTTTAAACcaccatgtacaacatgatggagacg
SRY_R	CCACTCCTCTGTGACACTTTAGCCCTCCGA	SRY_R : CCA CTC CTC TGT GAC ACT TTA GCC CTC CGA
Gibson_Cas9_F	CCACTTGTTTACTCTGACCAACTTG	Gibson_Cas9_F      CCACTTGTTTACTCTGACCAACTTG
genotip_AAVS_R2	CCAGACAGCCGCGTCAGAGCAGCTC	genotip_AAVS_R2    5' - CCAGACAGCCGCGTCAGAGCAGCTC -3'
q-gmR	CCAGCCACTACAAGCAGCAC	q-gmR CCAGCCACTACAAGCAGCAC 20
lvMKOS_recL	CCAGCCTGTACCTGCAGGACCTCACCGC	lvMKOS_recL  5-CCAGCCTGTACCTGCAGGACCTCACCGC-3
mCNTN5-RT-2_F	CCAGGAGCGGCCTGTGACTA	mCNTN5-RT-2_F      5' CCAGGAGCGGCCTGTGACTA 3'
qNvXistR	CCAGGCAATCTGCTCTGGAA	qNvXistR    CCAGGCAATCTGCTCTGGAA
D19Mit10R:	CCAGTCTGGACTTGTGAATGA	D19Mit10R: 5'-CCAGTCTGGACTTGTGAATGA
D19Mit10R	CCAGTCTGGACTTGTGAATGA	D19Mit10R  CCAGTCTGGACTTGTGAATGA
D19Mit10R2:	CCAGTCTGGACTTGTGAATGA	D19Mit10R2: 5'-CCAGTCTGGACTTGTGAATGA
D3S2406R	CCAGTTCCTGCTTCTTGAAA	D3S2406R    CCAGTTCCTGCTTCTTGAAA
5_tail_FOR	CCATCTCATCCCTGCGTGTCTCCGACTCAG	5_tail_FOR 5' CCATCTCATCCCTGCGTGTCTCCGACTCAG 3'
A12	CCATCTCATCCCTGCGTGTCTCCGACTCAGGGTGTCAAGCGATGTGCAGGAAACAGCTATGACC	A12    5'-CCATCTCATCCCTGCGTGTCTCCGACTCAGGGTGTCAAGCGATGTGCAGGAAACAGCTATGACC-3'
A12	CCATCTCATCCCTGCGTGTCTCCGACTCAGGGTGTCAAGCGATGTGCAGGAAACAGCTATGACC	A12        5'-CCATCTCATCCCTGCGTGTCTCCGACTCAGGGTGTCAAGCGATGTGCAGGAAACAGCTATGACC-3'
A11	CCATCTCATCCCTGCGTGTCTCCGACTCAGGTCGTCTAACGATGTGCAGGAAACAGCTATGACC	A11        5'-CCATCTCATCCCTGCGTGTCTCCGACTCAGGTCGTCTAACGATGTGCAGGAAACAGCTATGACC-3'
A11	CCATCTCATCCCTGCGTGTCTCCGACTCAGGTCGTCTAACGATGTGCAGGAAACAGCTATGACC	A11    5'-CCATCTCATCCCTGCGTGTCTCCGACTCAGGTCGTCTAACGATGTGCAGGAAACAGCTATGACC-3'
A10	CCATCTCATCCCTGCGTGTCTCCGACTCAGTTGAGACTGGGATGTGCAGGAAACAGCTATGACC	A10    5'-CCATCTCATCCCTGCGTGTCTCCGACTCAGTTGAGACTGGGATGTGCAGGAAACAGCTATGACC-3'
A10	CCATCTCATCCCTGCGTGTCTCCGACTCAGTTGAGACTGGGATGTGCAGGAAACAGCTATGACC	A10        5'-CCATCTCATCCCTGCGTGTCTCCGACTCAGTTGAGACTGGGATGTGCAGGAAACAGCTATGACC-3'
qNvSox2F	CCATCTCCGTGGTCTTCTTT	qNvSox2F    CCATCTCCGTGGTCTTCTTT
mtDNA_HhaI_Pr2	ccatctgcctacgacaaaca	mtDNA_HhaI_Pr2 ccatctgcctacgacaaaca
MpfGAPDHF	ccatcttccaggagcgagat	MpfGAPDHF ccatcttccaggagcgagat
CNTN6_Ex13D_R	CCATGCAAATAAAGATGGAGAGAGT	CNTN6_Ex13D_R  CCATGCAAATAAAGATGGAGAGAGT
PAX6-human	CCATGCAGATGCAAAAGTCCA	PAX6-human    F- CCATGCAGATGCAAAAGTCCA
mTph25UTR_55	CCATGGGTTTTGGAAGCAGAC	mTph25UTR_55 : CCATGGGTTTTGGAAGCAGAC
qCas9F	CCATGGTGATGCGGTTTTGG	qCas9F : CCATGGTGATGCGGTTTTGG
3'-uoTg-nu:	CCATGTGAACATGGACGTGGCTGC	3'-uoTg-nu:        5'-CCATGTGAACATGGACGTGGCTGC-3'
3C-R18_-4	CCATTGTCATTCAAACAAATACAGCCAG	3C-R18_-4    CCATTGTCATTCAAACAAATACAGCCAG
CNTN6_Ex14D_F	CCATTTCTCCCTTTCTGTCTGC	CNTN6_Ex14D_F  CCATTTCTCCCTTTCTGTCTGC
F:CTCTTTGGCTGAACACTCCAA	CCCAAAAAGGATTCCGTTCCA	F:CTCTTTGGCTGAACACTCCAA    Olig2.R:CCCAAAAAGGATTCCGTTCCA
CNTN6_Ex16D2_F	CCCAACCTAGGTGCCTTAGTG	CNTN6_Ex16D2_F    CCCAACCTAGGTGCCTTAGTG
qDlk1F	CCCAGGTGAGCTTCGAGTG	qDlk1F  CCCAGGTGAGCTTCGAGTG
134	CCCAGGTGAGTCTTCAGCTT	134 CCCAGGTGAGTCTTCAGCTT
Smcx_Pr1	CCCATCCTGTACAGTGTGGG	Smcx_Pr1 5'-CCCATCCTGTACAGTGTGGG
4C_primer	CCCATTGTCCTAGTAAAAGCTT	4C_primer 4_F  5' CCCATTGTCCTAGTAAAAGCTT 3'
MicePeg3IF	CCCCAAACACCATCTAAACTCTACAAAC	MicePeg3IF  > >> 5'-CCCCAAACACCATCTAAACTCTACAAAC-3'
MicePeg3IF	CCCCAAACACCATCTAAACTCTACAAAC	MicePeg3IF  > 5'-CCCCAAACACCATCTAAACTCTACAAAC-3'
116	CCCCCAAGTGATGCTTCTGT	116 CCCCCAAGTGATGCTTCTGT
DsRed1F	CCCCGTAATGCAGAAGAAGA	DsRed1F    CCCCGTAATGCAGAAGAAGA
5'-ATGCGGGAGATCGTGCACAT-3'	CCCCTGAGCGGACACTGT	5'-ATGCGGGAGATCGTGCACAT-3'              Tubb3.(2).R: 5'-CCCCTGAGCGGACACTGT-3'
5'-ATGCGGGAGATCGTGCACAT-3'	CCCCTGAGCGGACACTGT	5'-ATGCGGGAGATCGTGCACAT-3'          Tubb3.(2).R: 5'-CCCCTGAGCGGACACTGT-3'
5'-ATGCGGGAGATCGTGCACAT-3'	CCCCTGAGCGGACACTGT	5'-ATGCGGGAGATCGTGCACAT-3'                    Tubb3.(2).R: 5'-CCCCTGAGCGGACACTGT-3'
5'-ATGCGGGAGATCGTGCACAT-3'	CCCCTGAGCGGACACTGT	5'-ATGCGGGAGATCGTGCACAT-3'      Tubb3.(2).R: 5'-CCCCTGAGCGGACACTGT-3'
3C-F18_+4	CCCGAAATGATTCTTCAAATAAAGGTAGC	3C-F18_+4    CCCGAAATGATTCTTCAAATAAAGGTAGC
F:5'	CCCGAATATAAACACAACCC	F:5' - CCCGAATATAAACACAACCC -
Red2A	CCCGGCTACTACTACGTGGA	Red2A F - CCCGGCTACTACTACGTGGA
mCNTN5-RT-Ex7_F	CCCGGTTCCAACAATTACTTGGA	mCNTN5-RT-Ex7_F      5' CCCGGTTCCAACAATTACTTGGA 3'
CNTN6_Ex8D_R	CCCGTGACACTTTTTCACAACA	CNTN6_Ex8D_R    CCCGTGACACTTTTTCACAACA
38_g1chr15cut2RR	CCCTCCACAACAGACGTGTA	38_g1chr15cut2RR    CCCTCCACAACAGACGTGTA
D9S768F:	CCCTCCCACAAAATATATGC	D9S768F:  CCCTCCCACAAAATATATGC
NvSox2R	CCCTCTAGTTCACTGTCCGG	NvSox2R CCCTCTAGTTCACTGTCCGG
EScaseinGM_5H_OUT_F	ccctctccctactcttgggt	EScaseinGM_5H_OUT_F    ccctctccctactcttgggt
32_Brach-R	CCCTGAACATGTCCATCAGG	32_Brach-R CCCTGAACATGTCCATCAGG
hART1-RT-R	CCCTGGGTAAGGTTCAGTCC	hART1-RT-R      5' CCCTGGGTAAGGTTCAGTCC 3'
Inv-Skryre-beg:	CCGAATTCGAGCTCGGTACCCG	Inv-Skryre-beg: CCGAATTCGAGCTCGGTACCCG 22bp
DOP:	CCGACTCGAGNNNNNNATGTGG	DOP: 5-CCGACTCGAGNNNNNNATGTGG-3
F:5'-ACGCTGCTCAAGAAGGACAA-3'	CCGACTTGACCAGAGATCCG	F:5'-ACGCTGCTCAAGAAGGACAA-3'        Sox1.R:5'-CCGACTTGACCAGAGATCCG-3
F:5'-ACGCTGCTCAAGAAGGACAA-3'	CCGACTTGACCAGAGATCCG	F:5'-ACGCTGCTCAAGAAGGACAA-3'    Sox1.R:5'-CCGACTTGACCAGAGATCCG-3
GGGCTACATGAGCGCGT	CCGACTTGACCAGAGATCCG	GGGCTACATGAGCGCGT    Sox1.R: CCGACTTGACCAGAGATCCG
mEos_to_lego_F	CCGATTGACTGAGTCGCCCGatgAGTGCGATTAAGCCAGA	mEos_to_lego_F 5'-CCGATTGACTGAGTCGCCCGatgAGTGCGATTAAGCCAGA-3'
TKA_pa32	CCGCTCCTTTCGCTTTCTTC	TKA_pa32 CCGCTCCTTTCGCTTTCTTC
ZigGM3-F	CCGCTCTCTGGTCCCAAAGCTCA	ZigGM3-F            CCGCTCTCTGGTCCCAAAGCTCA
Zscan4c:	CCGGAGAAAGCAGTGAGGTGGA	"Zscan4c:    F: 5-CCGGAGAAAGCAGTGAGGTGGA-3;"
Zscan4c:	CCGGAGAAAGCAGTGAGGTGGA	"Zscan4c:      F: 5-CCGGAGAAAGCAGTGAGGTGGA-3;"
F:5'-	ccgtccaggagggcagaggaagtctgctaacatgcggtgacgtcgaggagaatcctggcccaatggagagctcatttaaatgactc	F:5'-  > ccgtccaggagggcagaggaagtctgctaacatgcggtgacgtcgaggagaatcctggcccaatggagagctcatttaaatgactc
hECAT15-2-S85	CCGTCCCCGCAATCTCCTTCCATC	hECAT15-2-S85 CCG TCC CCG CAA TCT CCT TCC ATC
3C-R18_0	CCGTGTAATAGTAGCCCAGCC	3C-R18_0    CCGTGTAATAGTAGCCCAGCC
bsIGCr1	CCTACTCTATAATACCCTATATAATTATACCATAA	bsIGCr1 5'-CCT ACT CTA TAA TAC CCT ATA TAA TTA TAC CAT AA-3'
MS2bb_Seq_Original_R	cctagaaggtccattagctgcaaagattcc	MS2bb_Seq_Original_R      5'-cctagaaggtccattagctgcaaagattcc-3'
mCNTN5-RT-Ex22_R	CCTCACTGTACGCTCGAACTTCAA	mCNTN5-RT-Ex22_R      5' CCTCACTGTACGCTCGAACTTCAA 3'
D13Mit64F2:	CCTCAGCACCAAAAAAGGAC	D13Mit64F2: 5'-CCTCAGCACCAAAAAAGGAC
D13Mit64F:	CCTCAGCACCAAAAAAGGAC	D13Mit64F: 5'-CCTCAGCACCAAAAAAGGAC
qMirgR	CCTCAGGTTCCTAAGCAAGG	qMirgR  CCTCAGGTTCCTAAGCAAGG
27_bottom	CCTCATGACCTTCGTCTATTAAGt	27_bottom 5'-CCTCATGACCTTCGTCTATTAAGt-3'
H19_Mice_IR	CCTCATTAATCCCATAACTAT	H19_Mice_IR  CCTCATTAATCCCATAACTAT  21
MinkNanog150F	CCTCCAGTGTCTCCTCTTCC	MinkNanog150F   CCTCCAGTGTCTCCTCTTCC
mtDNA_HhaI_Pr5	cctccctgtacgaaaggacaa	mtDNA_HhaI_Pr5 cctccctgtacgaaaggacaa
43_mEos2LegoF2:	CCTCCGATTGACTGAGTCGCCCGGATCCCGCCACCATGAGTGCGATTAAGCCAGAC	43_mEos2LegoF2: CCTCCGATTGACTGAGTCGCCCGGATCCCGCCACCATGAGTGCGATTAAGCCAGAC
EScaseinGM_3H_F	cctcgaagaggttcactaggc	EScaseinGM_3H_F    cctcgaagaggttcactaggc
4_bottom	CCTCTAGCTACCCACCTTTGACCt	4_bottom 5'-CCTCTAGCTACCCACCTTTGACCt-3'
primer	CCTCTCTATGGGCAGTCGGTGATatgctccccgggtaactaag	primer p1 (M2clad) 5'-CCTCTCTATGGGCAGTCGGTGATatgctccccgggtaactaag-3'
primer	CCTCTCTATGGGCAGTCGGTGATCACAAGAGGAGGAGGAGGTG	primer P1 5'-CCTCTCTATGGGCAGTCGGTGATCACAAGAGGAGGAGGAGGTG-3'
kit_up_T-vector_R	cctctgcagtcgacgGACTCACTGAGATGAAATGAAATG	kit_up_T-vector_R   5' cctctgcagtcgacgGACTCACTGAGATGAAATGAAATG 3'
integOri_L	CCTGACGAGCATCACAAAAA	integOri_L CCTGACGAGCATCACAAAAA 20
cNANOG100F	CCTGCATCCTTGCCAATGTC	cNANOG100F  CCTGCATCCTTGCCAATGTC
hTERT-S3234	CCTGCTCAAGCTGACTCGACACCGTG	hTERT-S3234 CCT GCT CAA GCT GAC TCG ACA CCG TG
Rnf12_checkR	CCTTCAGGCTCGTTTTCCGA	Rnf12_checkR 5'-CCTTCAGGCTCGTTTTCCGA-3'
3-p2B-conf	CCTTCATCCCATGTTCTGGTGTCTA	3-p2B-conf CCTTCATCCCATGTTCTGGTGTCTA
MAR-oTg	CCTTGCCACATATGCATTACCGTCTATG	MAR-oTg 5'-CCTTGCCACATATGCATTACCGTCTATG-3'
PRODH	CCTTTGGTGCTCTTCATCTTGTTGGTC	PRODH F: 5' - CCTTTGGTGCTCTTCATCTTGTTGGTC-
4C_primer	CGAAACGGCCAGAAGCTT	4C_primer 7_F  5' CGAAACGGCCAGAAGCTT 3'
5'-Skryre-in:	CGAAAGGGCCTCGTGATACGCC	5'-Skryre-in: CGAAAGGGCCTCGTGATACGCC
CNTN6_Ex18qPCR1_F	CGACAACCTGGTCCAAGGAG	CNTN6_Ex18qPCR1_F    CGACAACCTGGTCCAAGGAG
3'-Skryre-in:	CGACTGCATTAATGAATCGGCCAACG	3'-Skryre-in: CGACTGCATTAATGAATCGGCCAACG
qNCAM_31	CGACTTCCACTCAGCCTTGT	qNCAM_31 CGACTTCCACTCAGCCTTGT
MSX1_Mel_For	CGAGAGGACCCCGTGGATGCAGAG	MSX1_Mel_For    CGAGAGGACCCCGTGGATGCAGAG
Tph2Ex1_51+mEOS	CGAggaggtggaggtgggATGCAGCCCGCAATGATGATG	Tph2Ex1_51+mEOS : CGAggaggtggaggtggg ATGCAGCCCGCAATGATGATG
qnGtl2f	CGAGGGACAAGCGACAAAG	qnGtl2f  CGAGGGACAAGCGACAAAG
GGCGAATGGGTRAGTAACACG	CGATAACGCTTGCGACCTAT	GGCGAATGGGTRAGTAACACG                       MycoMorR: CGATAACGCTTGCGACCTAT
GGCGAATGGGTRAGTAACACG	CGATAACGCTTGCGACCTAT	GGCGAATGGGTRAGTAACACG                           MycoMorR: CGATAACGCTTGCGACCTAT
GGCGAATGGGTRAGTAACACG	CGATAACGCTTGCGACCTAT	GGCGAATGGGTRAGTAACACG                               MycoMorR: CGATAACGCTTGCGACCTAT
GGCGAATGGGTRAGTAACACG	CGATAACGCTTGCGACCTAT	GGCGAATGGGTRAGTAACACG               MycoMorR: CGATAACGCTTGCGACCTAT
GGCGAATGGGTRAGTAACACG	CGATAACGCTTGCGACCTAT	GGCGAATGGGTRAGTAACACG                   MycoMorR: CGATAACGCTTGCGACCTAT
GGCGAATGGGTRAGTAACACG	CGATAACGCTTGCGACCTAT	GGCGAATGGGTRAGTAACACG       MycoMorR: CGATAACGCTTGCGACCTAT
GGCGAATGGGTRAGTAACACG	CGATAACGCTTGCGACCTAT	GGCGAATGGGTRAGTAACACG           MycoMorR: CGATAACGCTTGCGACCTAT
GGCGAATGGGTRAGTAACACG	CGATAACGCTTGCGACCTAT	GGCGAATGGGTRAGTAACACG     MycoMorR: CGATAACGCTTGCGACCTAT
11_Cre_54	cgATGCCCAAGAAGAAGAGGAAGG	11_Cre_54 cgATGCCCAAGAAGAAGAGGAAGG
LAD1-1	CGATGGACTCCAGAGCGGCCGC	LAD1-1   5'-CGATGGACTCCAGAGCGGCCGCVNVNNNGGAA
tlCMV_33	CGCAAAACGCCTAACCCTAAG	tlCMV_33 : CGCAAAACGCCTAACCCTAAG
Clon-5short-2-R	CGCAAATCcacgtgggttgccaagatctgttttgag	Clon-5short-2-R    5'-CGCAAATCcacgtgggttgccaagatctgttttgag-3'
Clon-5short-2-R	CGCAAATCcacgtgggttgccaagatctgttttgag	Clon-5short-2-R        5'-CGCAAATCcacgtgggttgccaagatctgttttgag-3'
Clon-GFP-R	CGCAAATCGAATTCCCTGCAGGTTACTTGTACAGCTCGTCCATGC	Clon-GFP-R   5'-CGCAAATCGAATTCCCTGCAGGTTACTTGTACAGCTCGTCCATGC-3'
Clon-loxpPuro-R	CGCAAATCgcgatcgccaccGGCGCGCCtagtgaa	Clon-loxpPuro-R        5'-CGCAAATCgcgatcgccaccGGCGCGCCtagtgaa-3'
Clon-loxpPuro-R	CGCAAATCgcgatcgccaccGGCGCGCCtagtgaa	Clon-loxpPuro-R    5'-CGCAAATCgcgatcgccaccGGCGCGCCtagtgaa-3'
3H-mm-R	CGCAAATCGCGGCCGCCACCTGGCAGCTCTCTTACC	3H-mm-R    CGCAAATCGCGGCCGCCACCTGGCAGCTCTCTTACC
3H-hs-R	CGCAAATCGCGGCCGCTTGTGTGGCAGAGTCTGAGG	3H-hs-R    CGCAAATCGCGGCCGCTTGTGTGGCAGAGTCTGAGG
5H-mm-R	CGCAAATCGCTAGCATCTTCTCCTGAGGACCAGGAG	5H-mm-R    CGCAAATCGCTAGCATCTTCTCCTGAGGACCAGGAG
5H-hs-R	CGCAAATCGCTAGCGTCCTCCCCTGAGGACCAGG	5H-hs-R    CGCAAATCGCTAGCGTCCTCCCCTGAGGACCAGG
Clon-Puro-R	CGCAAATCGGATCCCACGTGTCAGGCACCGGGCTTGCG	Clon-Puro-R   5'-CGCAAATCGGATCCCACGTGTCAGGCACCGGGCTTGCG-3'
Clon-3'shortKO-R	CGCAAATCGGGCCCGTTTAAACAAAGGTGTCACATAGGCCAGA	Clon-3'shortKO-R     5'-CGCAAATCGGGCCCGTTTAAACAAAGGTGTCACATAGGCCAGA-3'
Clon-3'longKO-R	CGCAAATCGGGCCCGTTTAAACGGTCAGCATCCTTAGCCATCAG	Clon-3'longKO-R CGCAAATCGGGCCCGTTTAAACGGTCAGCATCCTTAGCCATCAG
Clon-3short-R	CGCAAATCGGGCCCGTTTAAACTTGACTGCTAACTGCATTTCTAC	Clon-3short-R   5'-CGCAAATCGGGCCCGTTTAAACTTGACTGCTAACTGCATTTCTAC-3'
Clon-5short-R	CGCAAATCTCTAGAGGTTGCCAAGATCTGTTTTGAG	Clon-5short-R   5'-CGCAAATCTCTAGAGGTTGCCAAGATCTGTTTTGAG-3'
VPR-BsrGI-R	CGCAAATCtgtacaAAACAGAGATGTGTCGAAGATGG	VPR-BsrGI-R    5-CGCAAATCtgtacaAAACAGAGATGTGTCGAAGATGG-3
Clon-CMV-R	CGCAAATCTGTACATGCTTATATAGACCTCCCACCG	Clon-CMV-R   5'-CGCAAATCTGTACATGCTTATATAGACCTCCCACCG-3'
D18Mit184R	CGCACAAGGACTACTGAAACA	D18Mit184R  CGCACAAGGACTACTGAAACA
PrR_gkdr1_AflII	cgcactcttaagGAAAGCTGGGTCTAGA	PrR_gkdr1_AflII cgcactcttaagGAAAGCTGGGTCTAGA
3C_BAC183_F1	CGCAGAAAGTCAAAGCATGA	3C_BAC183_F1 5'-CGCAGAAAGTCAAAGCATGA-3'
q-mGM2F2	CGCAGCCCTGGGAGCATGTG	q-mGM2F2  CGCAGCCCTGGGAGCATGTG
Clon-3'shortKO-R	CGCAgcgatcgcAAAGGTGTCACATAGGCCAGA	Clon-3'shortKO-R   5'-CGCAgcgatcgcAAAGGTGTCACATAGGCCAGA-3'
T4random25_up:	CGCAGGCACACgacagttNNNNNNNNNNNNNNNNNNNNNNNNNaactgtcCCTGTCTTGTGTC	T4random25_up:  > 5'-CGCAGGCACACgacagttNNNNNNNNNNNNNNNNNNNNNNNNNaactgtcCCTGTCTTGTGTC-3'
integProm_L	CGCCAATAGGGACTTTCCA	integProm_L CGCCAATAGGGACTTTCCA 19
mtDNA_Pr9	cgccgaccgttgactattctc	mtDNA_Pr9 cgccgaccgttgactattctc
Seq_gibson_ring_F	CGCCGACGCTAACCTCGATA	Seq_gibson_ring_F    5' CGCCGACGCTAACCTCGATA 3'
qSkryer-R	CGCCGGCAGCCTTCAATACG	qSkryer-R CGCCGGCAGCCTTCAATACG
hART5-RT-R	CGCCTCTTCTCCCCACCC	hART5-RT-R    5' CGCCTCTTCTCCCCACCC3'
primer4	CGCCTGGCATTATGCCCAGTAC	primer4 CGCCTGGCATTATGCCCAGTAC
Primer4	CGCCTGGCATTATGCCCAGTAC	Primer4 5'-CGCCTGGCATTATGCCCAGTAC
qPpiaF	CGCGTCTCCTTCGAGCTGTTTG	qPpiaF  CGCGTCTCCTTCGAGCTGTTTG
3C-F18_0UP	CGCGTGATCCTGGGGC	3C-F18_0UP : CGCGTGATCCTGGGGC
hSOX17-S423	CGCTTTCATGGTGTGGGCTAAGGACG	hSOX17-S423   CGC TTT CAT GGT GTG GGC TAA GGA CG
#?	cggccatagtaacttcttgca	#?
hBRACHYURY-AS1540	CGGCGCCGTTGCTCACAGACCACAGG	hBRACHYURY-AS1540  CGG CGC CGT TGC TCA CAG ACC ACA GG
qpBudZeoRR	CGGGACGACGTGACCCTGT	qpBudZeoRR CGGGACGACGTGACCCTGT 19b
qpBudZeoRR	CGGGACGACGTGACCCTGT	qpBudZeoRR   CGGGACGACGTGACCCTGT   19b
genotip_AAVS_R1	CGGGATTCTCCTCCACGTCACCGCA	genotip_AAVS_R1    5'- CGGGATTCTCCTCCACGTCACCGCA -3'
mtDNA_R	cgggggaataggttatgtga	mtDNA_R cgggggaataggttatgtga
TEasyBamhIRevPlus	CGGTAGGATCCGCGACATCACTAGTG	TEasyBamhIRevPlus   5'-CGGTAGGATCCGCGACATCACTAGTG -3'
TEasyBamhIRevPlus	CGGTAGGATCCGCGATATCACTAGTG	TEasyBamhIRevPlus   5'-CGGTAGGATCCGCGATATCACTAGTG-3'
P4_R1:	CGGTATCAACAGGGACAC	P4_R1: 5' CGGTATCAACAGGGACAC 3'
Fw1	CGTATGTGGCCGCTAACATT	Fw1 5'-CGTATGTGGCCGCTAACATT
tlCMV314	CGTCAATGGGCGGGGGTCGTTGG	tlCMV314 : CGTCAATGGGCGGGGGTCGTTGG
47_pT2-HR_R_2	CGTCACGAAGTCCAGCAAG	47_pT2-HR_R_2 CGTCACGAAGTCCAGCAAG
AC2:	CGTGAACGACGCGAG	AC2:      5'-CGTGAACGACGCGAG -3'
LAD3-2:	CGTGAACGACGCGAGCGGCCGC	LAD3-2:    5'-CGTGAACGACGCGAGCGGCCGCVNVNNNTATG
3'-oTghe-upd2:	CGTGAACGACGCGTCCGGCCTGTGGGTGCACTGGCAATTTGAAC	3'-oTghe-upd2:        5'-CGTGAACGACGCGTCCGGCCTGTGGGTGCACTGGCAATTTGAAC -3'
kdr_up_R	CGTGGCAAATTTAGGCAAGGA	kdr_up_R    5' CGTGGCAAATTTAGGCAAGGA 3'
Clon-5H-RPLCMNT-F	cgtggtaccccctctccctactcttgggt	Clon-5H-RPLCMNT-F    cgtggtaccccctctccctactcttgggt
mTph25UTR_54:	CGTTGCCTTCCATACGGAGT	mTph25UTR_54: CGTTGCCTTCCATACGGAGT
mEos2_33:	CGTTGCCTTCCATACGGAGT	mEos2_33: CGTTGCCTTCCATACGGAGT
qNvOct4R	CGTTGCGAATAGTCACTGCT	qNvOct4R   CGTTGCGAATAGTCACTGCT
BRACHYURY_Mel_Rev	CGTTGCTCACAGACCACA	BRACHYURY_Mel_Rev    CGTTGCTCACAGACCACA
hHPRT_BsmbI_F2	CTAAAAACGACTGTAAGTGAATTACTTC	hHPRT_BsmbI_F2 CTAAA AAC GACTGTAAGTGAATTACTT C
VPR-sg-olig_Oct4-OG2_2_DOWN	CTAAAACaatcccaccctctagccttgC	VPR-sg-olig_Oct4-OG2_2_DOWN     5'-CTAAAACaatcccaccctctagccttgC-3'
gIns-Brach-R2:	CTAAAACAATCCGCCGCACCCCCTGCCC	gIns-Brach-R2: CTAAAAC AATCCGCCGCACCCCCTGCC C
gIns-Brach-R3:	CTAAAACACGCGCTGTCCAAGCGCACAC	gIns-Brach-R3: CTAAAAC ACGCGCTGTCCAAGCGCACA C
VPR_sg-olig_Csn1S1_1_DOWN	CTAAAACatacctctcctgggaaattcC	VPR_sg-olig_Csn1S1_1_DOWN    5'-CTAAAACatacctctcctgggaaattcC-3'
gRNA_hART5_Ex2_1_DOWN	CTAAAACATGTGGGTTGTGCAGAGGAGC	gRNA_hART5_Ex2_1_DOWN           5'-CTAAAACATGTGGGTTGTGCAGAGGAGC-3'
sg-olig_Csn1s1_KO3_DOWN	CTAAAACcacattggttttttcagtatC	sg-olig_Csn1s1_KO3_DOWN     5'-CTAAAACcacattggttttttcagtatC-3'
27_bottom	ctaaaacCATGACCTTCGTCTATTAAGc	27_bottom 5'-ctaaaacCATGACCTTCGTCTATTAAGc-3'
26_gRNA_3-1-R:	CTAAAACCCCCACCCTATGGGCAGACAC	26_gRNA_3-1-R: CTAA AAC CCCCACCCTATGGGCAGACA C
10_gRNA_T_2R:	CTAAAACCCGAACGCGAACTGCGAGTGC	10_gRNA_T_2R: 5- CTAAAAC CCGAACGCGAACTGCGAGTG C  3
gIns-Brach-R1:	CTAAAACCCGCTTTTCCAAGAAAAAGGC	gIns-Brach-R1: CTAAAAC CCGCTTTTCCAAGAAAAAGG C
gRNA_hART4_Ex1_2_DOWN	CTAAAACCCTGCAACGATGAGAATCTGC	gRNA_hART4_Ex1_2_DOWN                 5'-CTAAAACCCTGCAACGATGAGAATCTGC-3'
45_bottom	ctaaaacCCTGCTAGGCTACTCTTCATc	45_bottom 5'-ctaaaacCCTGCTAGGCTACTCTTCATc-3'
07_bottom	ctaaaacCCTTGCATCCCCATGAAAATc	07_bottom 5'-ctaaaacCCTTGCATCCCCATGAAAATc-3'
30001_bottom	ctaaaacCGGCAAGGTTTTCGCTGGTCc	30001_bottom 5'-ctaaaacCGGCAAGGTTTTCGCTGGTCc-3'
28_gRNA_3-2-R:	CTAAAACCGGTTATTGTTTTGGCCAACC	28_gRNA_3-2-R: CTAA AAC CGGTTATTGTTTTGGCCAAC C
sg-olig_Csn1s1_ATG3_DOWN	CTAAAACcgtggctgctgcttttgctaC	sg-olig_Csn1s1_ATG3_DOWN     5'-CTAAAACcgtggctgctgcttttgctaC-3'
4_bottom	ctaaaacCTAGCTACCCACCTTTGACCc	4_bottom 5'-ctaaaacCTAGCTACCCACCTTTGACCc-3'
2_bottom	ctaaaacCTGTGGAGGAGGGGTCTACCc	2_bottom 5'-ctaaaacCTGTGGAGGAGGGGTCTACCc-3'
gRNA_hART4_Ex1_1_DOWN	CTAAAACCTGTGGGTCTCTGCAGGCCAC	gRNA_hART4_Ex1_1_DOWN           5'-CTAAAACCTGTGGGTCTCTGCAGGCCAC-3'
40002_bottom	ctaaaacCTTTTCAGCACTTACGGCGCc	40002_bottom 5'-ctaaaacCTTTTCAGCACTTACGGCGCc-3'
4_gRNA_Rosa_2R:	CTAAAACGAAGACTCCCGCCCATCTTCC	4_gRNA_Rosa_2R: CTAAAAC GAAGACTCCCGCCCATCTTC C
8_gRNA_T_1R:	CTAAAACGCGAGCTCATCCTCCCGCCAC	8_gRNA_T_1R: 5- CTAAAAC GCGAGCTCATCCTCCCGCCA C  3
24_gRNA_1-1-R:	CTAAAACGGGCTTCTTGGTTTTCCACAC	24_gRNA_1-1-R: CTAA AAC GGGCTTCTTGGTTTTCCACA C
VPR-sg-olig_Oct4-OG2_1_DOWN	CTAAAACgtgtcttccagacggaggttC	VPR-sg-olig_Oct4-OG2_1_DOWN     5'-CTAAAACgtgtcttccagacggaggttC-3'
gRNA_kdr_4_peak	ctaaaacTACCGGATTGCTCTTACCTCc	gRNA_kdr_4_peak 88.1 0 0 0 0_bottom   5' ctaaaacTACCGGATTGCTCTTACCTCc 3'
gRNA_AAVS_2	CTAAAACTAGTGGCCCCACTGTGGGGTC	gRNA_AAVS_2    5'- CTAAAACTAGTGGCCCCACTGTGGGGTC -
71_bottom	ctaaaacTCCTGTGTTCCGTGCCATTAc	71_bottom 5'-ctaaaacTCCTGTGTTCCGTGCCATTAc-3'
40004_bottom	ctaaaacTCGGTAAGTTTCCTGTCTTCc	40004_bottom 5'-ctaaaacTCGGTAAGTTTCCTGTCTTCc-3'
6_gRNA_Rosa_1R:	CTAAAACTCGTGATCTGCAACTCCAGTC	6_gRNA_Rosa_1R: CTAAAAC TCGTGATCTGCAACTCCAGT C
gRNA_Rosa26_R	CTAAAACTCTTCTAGAAAGACTGGAGTC	gRNA_Rosa26_R    5'- CTAAAACTCTTCTAGAAAGACTGGAGTC -
VPR_sg-olig_Csn1S1_2_DOWN	CTAAAACtgactatttaaactcactgaC	VPR_sg-olig_Csn1S1_2_DOWN    5'-CTAAAACtgactatttaaactcactgaC-3'
gRNA_kdr_4_peak	ctaaaacTGGAGTGGTGCCTGGACAGCc	gRNA_kdr_4_peak 97.5 0 0 2 7_bottom  5' ctaaaacTGGAGTGGTGCCTGGACAGCc 3'
gRNA_hART5_Ex2_2_DOWN	CTAAAACTGGGCCTGGCTCCAGACACCC	gRNA_hART5_Ex2_2_DOWN           5'-CTAAAACTGGGCCTGGCTCCAGACACCC-3'
VPR_sg-olig_Csn1S1_3_DOWN	CTAAAACTTGTCAGAAACAAAACCCACC	VPR_sg-olig_Csn1S1_3_DOWN    5'-CTAAAACTTGTCAGAAACAAAACCCACC-3'
hFGF4-RT-U	CTACAACGCCTACGAGTCCTACA	hFGF4-RT-U CTA CAA CGC CTA CGA GTC CTA CA
3C-F18_-4	CTACTGGAAGCTGTCCTCACATTTAC	3C-F18_-4    CTACTGGAAGCTGTCCTCACATTTAC
gRNA2_kdr_F	CTAGACCCAGCTTTCTTGTAAGAGGGCCTATTTCCCATGA	gRNA2_kdr_F    5' CTAGACCCAGCTTTCTTGTAAGAGGGCCTATTTCCCATGA 3'
IntCont_oIMR7338:	CTAGGCCACAGAATTGAAAGATCT	IntCont_oIMR7338:  CTAGGCCACAGAATTGAAAGATCT
IntCont_oIMR7338:	CTAGGCCACAGAATTGAAAGATCT	IntCont_oIMR7338: CTAGGCCACAGAATTGAAAGATCT
Trim71i12_51	CTATGCCCCTGCAGGCACCC	Trim71i12_51 CTATGCCCCTGCAGGCACCC
F:5'	CTCAAAATGTCATCCACCTT	F:5' - CTCAAAATGTCATCCACCTT -
hi-c_opistorchus_2	CTCAGCGTGACGCAGTTAAA	hi-c_opistorchus_2  5'-CTCAGCGTGACGCAGTTAAA
Gm11867-RT-1-R	CTCAGTTAACCCATTCAAGAAATCCTC	Gm11867-RT-1-R          5' CTCAGTTAACCCATTCAAGAAATCCTC 3'
Gm11867-RT-1-R	CTCAGTTAACCCATTCAAGAAATCCTC	Gm11867-RT-1-R      5' CTCAGTTAACCCATTCAAGAAATCCTC 3'
MS2_sg-oligdown	ctcatgttggcctagctcta	MS2_sg-oligdown      ctcatgttggcctagctcta
CNTN6_Ex7D_F	CTCCAGAAATGCTGCTAGCTCT	CNTN6_Ex7D_F    CTCCAGAAATGCTGCTAGCTCT
CNTN6_Ex9D_R	CTCCATTAACATTAGCTGTTTCTGT	CNTN6_Ex9D_R    CTCCATTAACATTAGCTGTTTCTGT
Gibson_RING_R	CTCCCCCGTTTAAACTCATTACTAACCGGTAGGGATCGAACCCTTTCACTTACACAAAGGACATTGTGAAG	Gibson_RING_R      CTCCCCCGTTTAAACTCATTACTAACCGGTAGGGATCGAACCCTTTCACTTACACAAAGGACATTGTGAAG
3-GM3-conf	CTCCCTGGGGAATGCATGCTTTG	3-GM3-conf CTCCCTGGGGAATGCATGCTTTG
3'-outT-6279	CTCCCTTCAAAACATGCAGCATAACTAACC	3'-outT-6279            CTCCCTTCAAAACATGCAGCATAACTAACC
Primer	ctCCGATTGACTGAGTCGCCCGATGGTGCGCTCCTCCAAG	Primer F1 -ctCCGATTGACTGAGTCGCCCGATGGTGCGCTCCTCCAAG
dsredfornew	ctCCGATTGACTGAGTCGCCCGgatcccGCCACCATGGTGCGCTCCTCCGAG	dsredfornew  5'-ctCCGATTGACTGAGTCGCCCGgatcccGCCACCATGGTGCGCTCCTCCGAG-3'
TTTGTCCGAGACCGAGAAGC	CTCCGGGAAGCGTGTACTTA	TTTGTCCGAGACCGAGAAGC    Sox2.R: CTCCGGGAAGCGTGTACTTA
hCNTN6ex2_31	ctcctcgcccttgctcacTAGCAACCTCATTTCCACTTTCT	hCNTN6ex2_31 ctcctcgcccttgctcacTAG CAA CCT CAT TTCCACTTTCT
qNvRex1R	CTCCTTGTCCATGGTCCTCG	qNvRex1R    CTCCTTGTCCATGGTCCTCG
mtDNA_Pr3	ctcgctaacctcgccttacc	mtDNA_Pr3 ctcgctaacctcgccttacc
olig_down	ctcggacgtctcgctaaaac	olig_down      5' ctcggacgtctcgctaaaac 3'
olig_down	ctcggacgtctcgctaaaac	olig_down    5' ctcggacgtctcgctaaaac 3'
3-GRE-mut-AS	CTCTCACGTAGGAAATCGATCATGTGTTCAGTTCCTCTCCCAAG	3-GRE-mut-AS CTCTCACGTAGGAAATCGATCATGTGTTCAGTTCCTCTCCCAAG
Nestin	CTCTCCCTGACTCTACTCCCT	Nestin F CTCTCCCTGACTCTACTCCCT
GAGGGCTGTCGGTGTGTG	CTCTCCCTGACTCTACTCCCT	GAGGGCTGTCGGTGTGTG    Nestin   F CTCTCCCTGACTCTACTCCCT
Tub/Tomato-3585:5'	CTCTGAGCCAGGAAGCAGTT	Tub/Tomato-3585:5' - CTCTGAGCCAGGAAGCAGTT -
SOX17_Mel_For	CTCTGCCTCCTCCACGAA	SOX17_Mel_For    CTCTGCCTCCTCCACGAA
Homozyg_check_F	CTCTTCCCTGTCACCCCAGTTC	Homozyg_check_F    5' CTCTTCCCTGTCACCCCAGTTC 3'
mCNTN5-RT-Ex3_R	CTGAAGAGTGGCTTCTCGACTA	mCNTN5-RT-Ex3_R      5' CTGAAGAGTGGCTTCTCGACTA 3'
Vermintide-F:	CTGAATTACCTTGCGCCTGCTCC	Vermintide-F:    5'-CTGAATTACCTTGCGCCTGCTCC-3'
Vermintide-F:	CTGAATTACCTTGCGCCTGCTCC	Vermintide-F:        5'-CTGAATTACCTTGCGCCTGCTCC-3'
mTg	CTGACACTACTTCCACCTTCTCCCC	mTg       CTGACACTACTTCCACCTTCTCCCC
mTg2	CTGACACTACTTCCACCTTCTCCCC	mTg2 CTGACACTACTTCCACCTTCTCCCC 25b
EScaseinGM_3H_KO_IN_R	ctgatatacacacatcattcctggt	EScaseinGM_3H_KO_IN_R ctgatatacacacatcattcctggt
EScaseinGM_3HKOIN_R	CTGATATACACACATCATTCCTGGT	EScaseinGM_3HKOIN_R    5'-CTGATATACACACATCATTCCTGGT-3'
5_tail_REV_6	CTGCAAGTTCATCACCGACTGCCCATAGAGAGG	5_tail_REV_6   CTGCAAGTTCATCACCGACTGCCCATAGAGAGG
NNS-up	CTGCAGGTGGGATTAACTGTGAATTCA	NNS-up 5'-CTGCAGGTGGGATTAACTGTGAATTCA-3'
Mef_testF	CTGCCAGTGCGCTCCACCTC	Mef_testF : 5-CTGCCAGTGCGCTCCACCTC-3
GFP_LegoG2_R	CTGCCTTGTAAGTCATTGGT	GFP_LegoG2_R   5' CTGCCTTGTAAGTCATTGGT 3'
hART4-RT-F	CTGCTCCTCTCTGGCCTGCA	hART4-RT-F      5' CTGCTCCTCTCTGGCCTGCA 3'
D3S1744R	CTGGCCCCATCTCTCTCTAT	D3S1744R    CTGGCCCCATCTCTCTCTAT
mCNTN5-RT-3_R	CTGGCCTTCCCGCACTGAGA	mCNTN5-RT-3_R      5' CTGGCCTTCCCGCACTGAGA 3'
qSyn1_31	CTGGGGATGAAGACTGGCTG	qSyn1_31 CTGGGGATGAAGACTGGCTG
OCT4_Mel_For	CTGGGTTGATCCTCGGACCT	OCT4_Mel_For   CTGGGTTGATCCTCGGACCT
3C-R18_+4	CTGGGTTTCTTCAGTGTGTGCC	3C-R18_+4    CTGGGTTTCTTCAGTGTGTGCC
qSOX2	CTGGTCATGGAGTTGTACTGCAGG	qSOX2 r:  CTGGTCATGGAGTTGTACTGCAGG
VASA_R_Schatten	CTGGTTGACCAATTCTCGAGT	VASA_R_Schatten    CTGGTTGACCAATTCTCGAGT
D3S2459F	CTGGTTTGGGTCTGTTATGG	D3S2459F    CTGGTTTGGGTCTGTTATGG
EScaseinGM_3H_KO_OUT_R	ctgtaaatagagaggcaaatgtatgg	EScaseinGM_3H_KO_OUT_R ctgtaaatagagaggcaaatgtatgg
D6Mit105F:	CTGTCTCCACTACTTCTATTCCTGG	D6Mit105F: 5'-CTGTCTCCACTACTTCTATTCCTGG
D6Mit105F2:	CTGTCTCCACTACTTCTATTCCTGG	D6Mit105F2: 5'-CTGTCTCCACTACTTCTATTCCTGG
Tdo	CTGTCTGCTCCTGCTCTGAT	Tdo R CTGTCTGCTCCTGCTCTGAT
Long	CTGTGGGTGTTTCTCGTAAGGTG	Long R 5' - CTGTGGGTGTTTCTCGTAAGGTG -
Tub/Tomato-5154:5'	CTGTTCGACATGCTCCACTG	Tub/Tomato-5154:5' - CTGTTCGACATGCTCCACTG -
cNANOGHayesR	CTGTTCTGAGTCACACTGTTGCTC	cNANOGHayesR CTGTTCTGAGTCACACTGTTGCTC
Cas9-3'-R	cttaatgcgccgctacagg	Cas9-3'-R    5'-cttaatgcgccgctacagg-3'
Long	CTTAGGGCTGGAGGTGGGAC	Long F 5' - CTTAGGGCTGGAGGTGGGAC -
hGDF3-S243	CTTATGCTACGTAAAGGAGCTGGG	hGDF3-S243 CTT ATG CTA CGT AAA GGA GCT GGG
hOCT4MatR	CTTCCCTCCAACCAGTTGCCCCAAAC	hOCT4MatR CTTCCCTCCAACCAGTTGCCCCAAAC
q-hOCT4endoR	CTTCCCTCCAACCAGTTGCCCCAAAC	q-hOCT4endoR  CTTCCCTCCAACCAGTTGCCCCAAAC  26b
5H-F-gibson	cttcctttctcgccacgttcgccggcagattggtacctgcatgaaaatttctgttgggtt	5H-F-gibson                   5'-cttcctttctcgccacgttcgccggcagattggtacctgcatgaaaatttctgttgggtt-3'
5H-F-gibson	cttcctttctcgccacgttcgccggcagattggtacctgcatgaaaatttctgttgggtt	5H-F-gibson               5'-cttcctttctcgccacgttcgccggcagattggtacctgcatgaaaatttctgttgggtt-3'
5H-F-gibson	cttcctttctcgccacgttcgccggcagattggtacctgcatgaaaatttctgttgggtt	5H-F-gibson    5'-cttcctttctcgccacgttcgccggcagattggtacctgcatgaaaatttctgttgggtt-3'
5H-F-gibson	cttcctttctcgccacgttcgccggcagattggtacctgcatgaaaatttctgttgggtt	5H-F-gibson           5'-cttcctttctcgccacgttcgccggcagattggtacctgcatgaaaatttctgttgggtt-3'
CDC7_down_check_F:	CTTCGTCGACCCAGCTTTCT	CDC7_down_check_F: 5' CTTCGTCGACCCAGCTTTCT 3'
NF200_qPCR_R	CTTCTCAGGGGATTTCGCCT	NF200_qPCR_R    CTTCTCAGGGGATTTCGCCT
MinkNanog150R	CTTCTGTTTCTTGCCCTGGG	MinkNanog150R   CTTCTGTTTCTTGCCCTGGG
3-GRE-mut-S	CTTGGGAGAGGAACTGAACACATGATCGATTTCCTACGTGAGAG	3-GRE-mut-S CTTGGGAGAGGAACTGAACACATGATCGATTTCCTACGTGAGAG
Tub/Tomato-7303R:5'	CTTGTACAGCTCGTCCATGC	Tub/Tomato-7303R:5' - CTTGTACAGCTCGTCCATGC -
Tomato689R	cttgtacagctcgtccatgc	Tomato689R  5'-cttgtacagctcgtccatgc
Tomat_NES_RC:	CTTGTACATTAaatatccaggcctgccagtttcagcgccagCTTGTACAGC	Tomat_NES_RC: CTTGTACATTAaatatccaggcctgccagtttcagcgccagCTTGTACAGC
BAC_Smcx_5	CTTGTGCAAATGGGTGTGTC	BAC_Smcx_5   CTTGTGCAAATGGGTGTGTC
3C-F18_0	CTTTGAGGAGTGTCATAACACACGG	3C-F18_0    CTTTGAGGAGTGTCATAACACACGG
qNvHprtF	CTTTGCTGACCTGCTGGATT	qNvHprtF      CTTTGCTGACCTGCTGGATT
EScaseinGM_5H_2_F	CTTTGTTCCAGTACGCTAAGAGC	EScaseinGM_5H_2_F      5' CTTTGTTCCAGTACGCTAAGAGC 3'
EScaseinGM_5H_2_F	CTTTGTTCCAGTACGCTAAGAGC	EScaseinGM_5H_2_F          5' CTTTGTTCCAGTACGCTAAGAGC 3'
FOS-down	GAAAACTCTTTGTTTGGATGCTAATGGGATACTT	FOS-down 5'-GAAAACTCTTTGTTTGGATGCTAATGGGATACTT-3'
FmOmS-down	GAAAACTGGACAGGTGGATTTGAAAGGGATACTT	FmOmS-down 5'-GAAAACTGGACAGGTGGATTTGAAAGGGATACTT-3'
FmOmS-down	GAAAACTGGACAGGTGGATTTGAAAGGGATACTTAAA	FmOmS-down 5'-GAAAACTGGACAGGTGGATTTGAAAGGGATACTTAAA-3'
Gm11867-RT-2-F	GAAAGCAACGCATGCTTCATAGG	Gm11867-RT-2-F          5' GAAAGCAACGCATGCTTCATAGG 3'
Gm11867-RT-2-F	GAAAGCAACGCATGCTTCATAGG	Gm11867-RT-2-F      5' GAAAGCAACGCATGCTTCATAGG 3'
qnGtl2r	GAAAGGGCTCAGACTCAAGACA	qnGtl2r  GAAAGGGCTCAGACTCAAGACA
f1_ori_31	GAACCCTAAAGGGATGCCCC	f1_ori_31 : GAACCCTAAAGGGATGCCCC
EGFP_Alex_R	GAACTCCAGCAGGACCATGT	EGFP_Alex_R  GAACTCCAGCAGGACCATGT
TKApA_33	gaagaaagcgaaaggagcgg	TKApA_33 : gaagaaagcgaaaggagcgg
4C_primerDpn_12_R	GAAGAAGCACTAACCATTGAGA	4C_primerDpn_12_R   5' GAAGAAGCACTAACCATTGAGA 3'
40004_bottom	GAAGACAGGAAACTTACCGAAGG	40004_bottom 5'-GAAGACAGGAAACTTACCGAAGG-3'
D3S2398R	GAAGACCTACGGATTGGGTC	D3S2398R    GAAGACCTACGGATTGGGTC
EGFP_qPCR_F	GAAGCAGCACGACTTCTTCAA	EGFP_qPCR_F   GAAGCAGCACGACTTCTTCAA
NANOG_Mel_Rev	GAAGGAAGAGGAGAGACAGT	NANOG_Mel_Rev   GAAGGAAGAGGAGAGACAGT
Esg1F	GAAGTCTGGTTCCTTGGCAGGATG	Esg1F 5-GAAGTCTGGTTCCTTGGCAGGATG-3
Primer	gaagttagtggctccgcttccCAGGAACAGGTGGTGGCG	Primer R1 -gaagttagtggctccgcttccCAGGAACAGGTGGTGGCG
ctCCGATTGACTGAGTCGCCCGATGGACAACACCGAGGAC	gaagttagtggctccgcttccCTGGGAGCCGGAGTGGCGg	ctCCGATTGACTGAGTCGCCCGATGGACAACACCGAGGAC     R1 - gaagttagtggctccgcttccCTGGGAGCCGGAGTGGCGg
RT-mCNBD1-1-F	GAATGCCTTATGCCACATTAGAGG	RT-mCNBD1-1-F      5' GAATGCCTTATGCCACATTAGAGG 3'
D4Mit203F	GAATTCTTCCTGGGCCTTTC	D4Mit203F  GAATTCTTCCTGGGCCTTTC
CNTN6_Ex22D2_R	GAATTTCATGCTGCAGCTGTCT	CNTN6_Ex22D2_R   GAATTTCATGCTGCAGCTGTCT
T4random25_down:	GACACAAGACAGGgacagtt	T4random25_down:  5'-GACACAAGACAGGgacagtt-3'
RT-GCSF-R	GACACCTCCAGGAAGCTCTG	RT-GCSF-R   5'- GACACCTCCAGGAAGCTCTG -3'
D3S2460R	GACAGGAGACAGAATGTTATAAGTT	D3S2460R    GACAGGAGACAGAATGTTATAAGTT
Kdr_98_CheckPrimer_F	GACAGGCACGGAGTTCAAAT	Kdr_98_CheckPrimer_F    5' GACAGGCACGGAGTTCAAAT 3'
hOCT4MatF	GACAGGGGGAGGGGAGGAGCTAGG	hOCT4MatF GACAGGGGGAGGGGAGGAGCTAGG
q-hOCT4endoF	GACAGGGGGAGGGGAGGAGCTAGG	q-hOCT4endoF  GACAGGGGGAGGGGAGGAGCTAGG  24b
CMV1_F	GACCCCCGCCCATTGACGTC	CMV1_F    5' GACCCCCGCCCATTGACGTC 3
16_Rosa	gaccgccctgggcct	16_Rosa 1-2_F: gaccgccctgggcct
SOX	GACGCTCATGAAGAAGGATAAG	SOX For: 5' - GACGCTCATGAAGAAGGATAAG
c-kit_doublegRNA_check_F	GACGTGAACATGAGGTGGAG	c-kit_doublegRNA_check_F 5' GACGTGAACATGAGGTGGAG  3'
kdr_guide_2_bottom	GACTAGCCTTATTTTAACTTGCTATTTCTAGCTCTAAAACCACCAGTCATGAACAAATCGt	kdr_guide_2_bottom      5' GACTAGCCTTATTTTAACTTGCTATTTCTAGCTCTAAAACCACCAGTCATGAACAAATCGt
gInsR18	gactagccttattttaacttgctatttctagctctaaaaccagtctccggtgttctctaC	gInsR18 gactagccttattttaacttgctatttctagctctaaaac cagtctccggtgttctcta C
Rnf12_gRNAdown	GACTAGCCTTATTTTAACTTGCTATTTCTAGCTCTAAAACctcgagaaggtctggccgaC	Rnf12_gRNAdown 5'-GACTAGCCTTATTTTAACTTGCTATTTCTAGCTCTAAAACctcgagaaggtctggccgaC-3'
gInsR13	gactagccttattttaacttgctatttctagctctaaaacGCAGAAGAGTTTATGAGTGC	gInsR13 gactagccttattttaacttgctatttctagctctaaaac GCAGAAGAGTTTATGAGTG C
gInsR17	gactagccttattttaacttgctatttctagctctaaaacgtgttctctagggcatcaaC	gInsR17 gactagccttattttaacttgctatttctagctctaaaac gtgttctctagggcatcaa C
gInsR15	gactagccttattttaacttgctatttctagctctaaaacGTTTCCATAGCAACCTCATC	gInsR15 gactagccttattttaacttgctatttctagctctaaaac GTTTCCATAGCAACCTCAT C
c-kit_guide_2_bottom	GACTAGCCTTATTTTAACTTGCTATTTCTAGCTCTAAAACTACTGAGCAATTCGTGTGAGa	c-kit_guide_2_bottom     5' GACTAGCCTTATTTTAACTTGCTATTTCTAGCTCTAAAACTACTGAGCAATTCGTGTGAGa 3'
gInsR14	gactagccttattttaacttgctatttctagctctaaaacTAGCAACCTCATTTCCACTC	gInsR14 gactagccttattttaacttgctatttctagctctaaaac TAGCAACCTCATTTCCACT C
gInsR16	gactagccttattttaacttgctatttctagctctaaaactatggacacctgctgtagaC	gInsR16 gactagccttattttaacttgctatttctagctctaaaac tatggacacctgctgtaga C
tgfbr_grna_botom_s	GACTAGCCTTATTTTAACTTGCTATTTCTAGCTCTAAAACTTTCGATGAGGGAAGGGTTTC	tgfbr_grna_botom_s 5'-GACTAGCCTTATTTTAACTTGCTATTTCTAGCTCTAAAACTTTCGATGAGGGAAGGGTTTC-3'
Esp_adaptor	GACTAGCCTTATTTTAACTTGCTATTTCTAGCTCTAAAGAGACGatgcatCGTCTCCGG	Esp_adaptor down 5'-GACTAGCCTTATTTTAACTTGCTATTTCTAGCTCTAAAGAGACGatgcatCGTCTCCGG-3'
DTA_R:	gactcactataggggatAGTGCACCATTCGAGCAG	DTA_R: 5'  gactcactataggggatAGTGCACCATTCGAGCAG  3'
uoTg	GACTGAAATGACAGCATGCACGC	uoTg       5'-GACTGAAATGACAGCATGCACGC  23b
4C_primerHind_12_F	GACTGTGACACCTAATAAGCTT	4C_primerHind_12_F   5' GACTGTGACACCTAATAAGCTT 3'
kdr_down_T-vector_F	gacttacaaggcagaatTGTTCATGACTGGTGGCTC	kdr_down_T-vector_F  5' gacttacaaggcagaatTGTTCATGACTGGTGGCTC  3'
Seq_VPR_F	GACTTTGACCTCGACATGCTCGG	Seq_VPR_F    5'-GACTTTGACCTCGACATGCTCGG-3'
H19_Mice_IF	GAGAAAATAGTTATTGTTTATAGTTTT	H19_Mice_IF  GAGAAAATAGTTATTGTTTATAGTTTT  27
1237L	GAGAAACTGTGCAAAACAG	1237L 5'-GAGAAACTGTGCAAAACAG-3'
cRex1-561F	GAGAAAGCATCTCCTCGTCCA	cRex1-561F  GAGAAAGCATCTCCTCGTCCA
ESmmnestinGFP-OUT-R	GAGAGCAACCAGTCCCTTCC	ESmmnestinGFP-OUT-R    GAGAGCAACCAGTCCCTTCC
3'-oTg-hope	GAGAGCTCAGTACAAAAGTACAACGTGTAG	3'-oTg-hope = GAGAGCTCAGTACAAAAGTACAACGTGTAG
Zscan4:	GAGATTCATGGAGAGTCTGACTGATGAGTG	Zscan4:      F: 5-GAGATTCATGGAGAGTCTGACTGATGAGTG-3
Zscan4:	GAGATTCATGGAGAGTCTGACTGATGAGTG	Zscan4:    F: 5-GAGATTCATGGAGAGTCTGACTGATGAGTG-3
Nestin	GAGCAGTCTCGTGGGAAAG	Nestin N r GAGCAGTCTCGTGGGAAAG
Rnf12_checkF	GAGCAGTGAGCCGGACTAAT	Rnf12_checkF 5'-GAGCAGTGAGCCGGACTAAT-3'
qTuj1_51	GAGCGCATCAGCGTATACTACAA	qTuj1_51 : GAG CGC ATC AGC GTA TAC TACAA
2A51	GAGGGCAGAGGAAGTCTGCTAACATG	2A51 : 5-GAGGGCAGAGGAAGTCTGCTAACATG-3
113	GAGGGGTGGGGAGATGAGTA	113 GAGGGGTGGGGAGATGAGTA
EScaseinGM_3HKO_FAR_R	GAGGGTCCAGTCACATCTGTAAA	EScaseinGM_3HKO_FAR_R      5' GAGGGTCCAGTCACATCTGTAAA 3'
CDC7_up_check_F	GAGGTAGGCTCTCCCACCTT	CDC7_up_check_F 5' GAGGTAGGCTCTCCCACCTT 3'
CDC7_up_check_F:	GAGGTAGGCTCTCCCACCTT	CDC7_up_check_F: 5' GAGGTAGGCTCTCCCACCTT 3'
R:5'-	gagtcatttaaatgagctctccattgggccaggattctcctcgacgtcaccgcatgttagcagacttcctctgccctcctggacgg	R:5'-  > gagtcatttaaatgagctctccattgggccaggattctcctcgacgtcaccgcatgttagcagacttcctctgccctcctggacgg
Clon-3'longKO-N-R	GAGTGCAAGGGCCCGTTTAAACTGAAAGGACACTCCACCACA	Clon-3'longKO-N-R     5'-GAGTGCAAGGGCCCGTTTAAACTGAAAGGACACTCCACCACA-3'
41_g1chr6cut2RR	GAGTGGATGTGTAGAGAATGAGTT	41_g1chr6cut2RR    GAGTGGATGTGTAGAGAATGAGTT
D3S3038R	GATACCATATTCAACATGAAGAGG	D3S3038R    GATACCATATTCAACATGAAGAGG
qNvOct4F	GATCAGCCACATTGCCCAG	qNvOct4F    GATCAGCCACATTGCCCAG
Inp2S	GATCCGTACATGTGTAATAGCTCCttcaagagaGGAGCTATTACACATGTACTTTTTTGGTAC	Inp2S  GATCCGTACATGTGTAATAGCTCCttcaagagaGGAGCTATTACACATGTACTTTTTTGGTAC
G418_F	GATCGGCCATTGAACAAGAT	G418_F  5' GATCGGCCATTGAACAAGAT 3'
MutMroF	GATGAAGCCGAACGACTTGT	MutMroF 5'-GATGAAGCCGAACGACTTGT-3'
CTCTAGCCGCGTGAAGTCAG	GATGACCTCCCAGAACTTGGC	CTCTAGCCGCGTGAAGTCAG    Tubb3.R: GATGACCTCCCAGAACTTGGC
RT-mCNBD1-5-R	GATGCCCAAAAGTTGGTTTTGC	RT-mCNBD1-5-R        5' GATGCCCAAAAGTTGGTTTTGC 3'
Seq_GMCSF_2_F	GATGGCCAGCCACTACAAGC	Seq_GMCSF_2_F    GATGGCCAGCCACTACAAGC
hNANOGMatR	GATGGGAGGAGGGGAGAGGA	hNANOGMatR GATGGGAGGAGGGGAGAGGA
H19_Mice_OF	GATTAGATAGTATTGAGTTTGTTTGGAGT	H19_Mice_OF  GATTAGATAGTATTGAGTTTGTTTGGAGT  29
RT-mCNBD1-4-R	GATTCTTAGGGAACGTTGGCCA	RT-mCNBD1-4-R        5' GATTCTTAGGGAACGTTGGCCA 3'
hcMYCMatR	GATTGAAATTCTGTGTAACTGC	hcMYCMatR GATTGAAATTCTGTGTAACTGC
2nd	GCAAAAGTGCTCAGCCTACC	2nd peak R 5' GCAAAAGTGCTCAGCCTACC 3'
qpTandemAmpRF	GCAACTTTATCCGCCTCCATC	qpTandemAmpRF GCAACTTTATCCGCCTCCATC 21b
qpTandemAmpRF	GCAACTTTATCCGCCTCCATC	qpTandemAmpRF    GCAACTTTATCCGCCTCCATC       21b
tgfbr_checkup_F	GCAATGCTGTTCTTCCGCTC	tgfbr_checkup_F 5'-GCAATGCTGTTCTTCCGCTC-3'
kdr_double	GCACTGTCACTTACCCAGCA	kdr_double gRNA_check_F 5' GCACTGTCACTTACCCAGCA 3'
CMV311	GCAGAACGTGGGGCTCACCTC	CMV311 :  GCAGAACGTGGGGCTCACCTC
tlCMV312	GCAGAACGTGGGGCTCACCTCGACC	tlCMV312 : GCAGAACGTGGGGCTCACCTCGACC
5'-3'	GCAGCAGATCAGCCACATT	5'-3'          NvOct4e4F GCAGCAGATCAGCCACATT
5'-3'	GCAGCAGATCAGCCACATT	5'-3'      NvOct4e4F GCAGCAGATCAGCCACATT
schicHind_check2	GCAGCAGCACTCGTTTCTTG	schicHind_check2 5'-GCAGCAGCACTCGTTTCTTG-3'
Fw2	GCAGCAGTTGCTCTTGTGAC	Fw2 5'-GCAGCAGTTGCTCTTGTGAC
iTg1	GCAGCATGCATCGATAGATCTCG	iTg1   GCAGCATGCATCGATAGATCTCG 23b
Reverse	GCAGCTGCACGGGCTTCTTG	Reverse primer GCAGCTGCACGGGCTTCTTG Minus
DsRed1_OlyaR	GCAGCTGCACGGGCTTCTTG	DsRed1_OlyaR GCAGCTGCACGGGCTTCTTG
c-kit_doublegRNA_check_R	GCAGCTGCAGAACACATAGC	c-kit_doublegRNA_check_R 5' GCAGCTGCAGAACACATAGC 3'
tlRGS516	GCAGCTTATAATGGTTACAAATAAAGCAATAGCATC	tlRGS516 : GCAGCTTATAATGGTTACAAATAAAGCAATAGCATC
tlRGS513	GCAGTGGCGTGATTCCCTGGACA	tlRGS513 GCAGTGGCGTGATTCCCTGGACA
CNTN6_Ex23D_R	GCAGTTACAACTCCCCAGGT	CNTN6_Ex23D_R  GCAGTTACAACTCCCCAGGT
Puro32+NsiI	GCATCATGCATTCAGGCACCGGGCTTGCGGGTCA	Puro32+NsiI  5-GCATCATGCATTCAGGCACCGGGCTTGCGGGTCA-3
Puro51+KpnI	GCATCGGTACCATGACCGAGTACAAGCCCACGG	Puro51+KpnI 5-GCATCGGTACCATGACCGAGTACAAGCCCACGG-3
mtDNA_Pr4	gcatgatgaaacttcggctca	mtDNA_Pr4 gcatgatgaaacttcggctca
3C-R18_+6	GCATGGCAGATCCAGGGAAAC	3C-R18_+6    GCATGGCAGATCCAGGGAAAC
5'-Molder-out	GCATGGCGGTAATACGGTTATCCACAG	5'-Molder-out GCATGGCGGTAATACGGTTATCCACAG
129	GCATTCCTGTCCTTCCATTCTATT	129 GCATTCCTGTCCTTCCATTCTATT
kit_up_T-vector_F	gccaatcggatcccgTGAGAGGCAAGGGGAGAC	kit_up_T-vector_F   5' gccaatcggatcccgTGAGAGGCAAGGGGAGAC 3'
AFP_Mel_Rev	GCCACAGGCCAATAGTTTGT	AFP_Mel_Rev   GCCACAGGCCAATAGTTTGT
hKLF4MatF	GCCACCCACACTTGTGATT	hKLF4MatF GCCACCCACACTTGTGATT
chic1	GCCACCTGATCCACCTAAAA	chic1 5'-GCCACCTGATCCACCTAAAA-3'
Dazl	GCCAGCACTCAGTCTTCATC	Dazl   5' GCCAGCACTCAGTCTTCATC 3'
111	GCCAGCTTGACTGACAGCTA	111         GCCAGCTTGACTGACAGCTA
BAC_Smcx_3	GCCAGTAGGTAACCCCTTCC	BAC_Smcx_3   GCCAGTAGGTAACCCCTTCC
Vasya_plasmidF	gccatcacgagatttcgatt	Vasya_plasmidF 5'-gccatcacgagatttcgatt-3'
CNTN6_Ex17D_F	GCCATCCCACATTTCTCTTGG	CNTN6_Ex17D_F  GCCATCCCACATTTCTCTTGG
Inp2AS	GCCATGTACACATTATCGAGGaagttctctCCTCGATAATGTGTACATGAAAAAAC	Inp2AS        GCCATGTACACATTATCGAGGaagttctctCCTCGATAATGTGTACATGAAAAAAC
VASA/DDX4:	GCCCAGGAATGCCATCAAAG	VASA/DDX4: 5' GCCCAGGAATGCCATCAAAG 3'
hART3-RT-R	GCCCGAGGATGCAGAAGGATG	hART3-RT-R      5' GCCCGAGGATGCAGAAGGATG 3'
Ddx3x_Pr3	GCCCTAACAATGGTAACA	Ddx3x_Pr3 5'-GCCCTAACAATGGTAACA
hBRACHYURY-S1292	GCCCTCTCCCTCCCCTCCACGCACAG	hBRACHYURY-S1292   GCC CTC TCC CTC CCC TCC ACG CAC AG
Inp1AS	GCCTAGGCCATGGG	Inp1AS  GCCTAGGCCATGGG
Kdr_96_CheckPrimer_R	GCCTCCTGTTGTGCATTGTA	Kdr_96_CheckPrimer_R    5'GCCTCCTGTTGTGCATTGTA 3'
mTph25UTR_54	GCCTCGAATTTCAAAAGCCTGA	mTph25UTR_54 : GCCTCGAATTTCAAAAGCCTGA
tlRGS514	GCCTCGCTTTGTGCGCTCTGAGTTTTA	tlRGS514 : GCCTCGCTTTGTGCGCTCTGAGTTTTA
Seq_RNF169_1	GCCTGGGGAACTTCGTGAGGAAT	Seq_RNF169_1      5' GCCTGGGGAACTTCGTGAGGAAT 3'
3C-R18_-6	GCCTTACTGTGAAGCTGTGTTACA	3C-R18_-6    GCCTTACTGTGAAGCTGTGTTACA
D19Mit10F:	GCCTTTAAGCCAGTCAAGACA	D19Mit10F: 5'-GCCTTTAAGCCAGTCAAGACA
D19Mit10F2:	GCCTTTAAGCCAGTCAAGACA	D19Mit10F2: 5'-GCCTTTAAGCCAGTCAAGACA
D19Mit10F	GCCTTTAAGCCAGTCAAGACA	D19Mit10F  GCCTTTAAGCCAGTCAAGACA
Hygr_F	GCGACGTCTGTCGAGAAGTT	Hygr_F  5' GCGACGTCTGTCGAGAAGTT 3'
Tub/Tomato-5909:5'	GCGAGGAGGTCATCAAAGAG	Tub/Tomato-5909:5' - GCGAGGAGGTCATCAAAGAG -
schicHind_check1	GCGAGGCAGCATTCCTTGAT	schicHind_check1 5'-GCGAGGCAGCATTCCTTGAT-3'
2nd	GCGAGGGGCTGGTACAATAA	2nd peak r 5'-GCGAGGGGCTGGTACAATAA-3'
Seq_5H_end_F	gcgcataactaagcatcttatgct	Seq_5H_end_F    gcgcataactaagcatcttatgct
40002_bottom	GCGCCGTAAGTGCTGAAAAGAGGT	40002_bottom 5'-GCGCCGTAAGTGCTGAAAAGAGGT-3'
q-mGM2R	GCGGGTCTGTAGGCAGGTCG	q-mGM2R    GCGGGTCTGTAGGCAGGTCG
hREX1-RT-L	GCGTACGCAAATTAAAGTCCAGA	hREX1-RT-L GCG TAC GCA AAT TAA AGT CCA GA
F:5'-	gcgtcgaattcaggtcgtgaaacagactttgaattttgaccttctcaagttggcgggagacgtggagtccaacccagggcccatggcgaccgca	F:5'-  > gcgtcgaattcaggtcgtgaaacagactttgaattttgaccttctcaagttggcgggagacgtggagtccaacccagggcccatggcgaccgca
gibsAP2Pr51	GCGTTGGGAGCTCTCCCATATGGTCGACCTGCAGGGAATTCCCAGCAGGAATCAGGT	gibsAP2Pr51 : GCGTTGGGAGCTCTCCCATATGGTCGACCTGCAGG GAATTCCCAGCAGGAATCAGGT
cRex1-711R	GCGTTTCCCACATCCTTCAA	cRex1-711R  GCGT TTCCCACATCCTTCAA
Gm3-R	GCTAGACTAGAGGACCAGCAAAA	Gm3-R    5' - GCTAGACTAGAGGACCAGCAAAA -
qpcr_LTB_R	GCTAGATTCCTGGAAGCATT	qpcr_LTB_R : GCTAGATTCCTGGAAGCATT
qLtb	GCTAGATTCCTGGAAGCATT	qLtb r:GCTAGATTCCTGGAAGCATT
gRNAcheck_R	GCTATTTCTAGCTCTAAAAC	gRNAcheck_R       5'-GCTATTTCTAGCTCTAAAAC-3'
tlGFP_312	GCTCCTCGCCCTTGCTCACC	tlGFP_312         5-GCTCCTCGCCCTTGCTCACC-3
Csn1s1-end-R	GCTCTCCGTGTTACTGAGAAGG	Csn1s1-end-R      5' GCTCTCCGTGTTACTGAGAAGG 3'
chickHi-C2	GCTGAAGTGGCTGAGAAAGG	chickHi-C2 5'-GCTGAAGTGGCTGAGAAAGG-3'
qMap2_31	GCTGAGGAACCTTAATTCTTGCC	qMap2_31 GCTGAGGAACCTTAATTCTTGCC
2_hCNTN6_ex5_31:	GCTGCACTAATGGAGTGGGT	2_hCNTN6_ex5_31: GCTGCACTAATGGAGTGGGT
Cas9_52	GCTGCAGAAAGGTAACGAGC	Cas9_52  GCTGCAGAAAGGTAACGAGC
BAC_Smcx_	GCTGCTGCTCTTGCTGTTAC	BAC_Smcx_ 2   GCTGCTGCTCTTGCTGTTAC
rbbp8r	gctggatcctatgtcttctgctccttgc	rbbp8r 5'-gctggatcctatgtcttctgctccttgc
qNvXistF	GCTGGATTGCCACCCCTTAT	qNvXistF    GCTGGATTGCCACCCCTTAT
gRNA1_kdr_Gibson_F	GCTGGCCTTTTGCTCACATGAGAGGGCCTATTTCCCATGA	gRNA1_kdr_Gibson_F   5' GCTGGCCTTTTGCTCACATGAGAGGGCCTATTTCCCATGA 3'
Tomat_NES:	GCTGTACAAGctggcgctgaaactggcaggcctggatattTAATGTACAAG	Tomat_NES: GCTGTACAAG ctg gcg ctg aaa ctg gca ggc ctg gat att TAA TGTACAAG
q-mOct4R	GCTTAGCCAGGTTCGAGGAT	q-mOct4R  GCTTAGCCAGGTTCGAGGAT  20b
SchicMbo_check1	GCTTCCGGCGAAGATGTAGA	SchicMbo_check1 5'-GCTTCCGGCGAAGATGTAGA-3'
M2rt_EcoRIR	gcttGAATTCgaattgatccttacttagttacc	M2rt_EcoRIR 5'-gcttGAATTCgaattgatccttacttagttacc-3'
phCas9_51	GCTTGACCGACAATTGCATGA	phCas9_51 : GCTTGACCGACAATTGCATGA
33_T	GCTTGCAGCACGCACCTA	33_T 1-2_R2 GCTTGCAGCACGCACCTA
pBMN-5	GCTTGGATACACGCCGC	pBMN-5  GCTTGGATACACGCCGC
hTERT-AS3713	GGAAAAGCTGGCCCTGGGGTGGAGC	hTERT-AS3713 GGA AAA GCT GGC CCT GGG GTG GAG C
Neurofilament	GGAAAATGAACTTCGGGG	Neurofilament                F GGAAAATGAACTTCGGGG
Neurofilament	GGAAAATGAACTTCGGGG	Neurofilament  >> F GGAAAATGAACTTCGGGG
Neurofilament	GGAAAATGAACTTCGGGG	Neurofilament  >>>> F GGAAAATGAACTTCGGGG
Seq_GMCSF_end_2_F	GGAAACTTCCTGTGCAACCCAG	Seq_GMCSF_end_2_F    5'-GGAAACTTCCTGTGCAACCCAG-3'
BackboneFV_3H_R	ggaaagcttgcatgcaggcctc	BackboneFV_3H_R       5-ggaaagcttgcatgcaggcctc-3
R:5'	GGAAAGGACAGTGGGAGTGG	R:5' - GGAAAGGACAGTGGGAGTGG -
CDC7_up_check_R:	GGAAAGTCCCTATTGGCGTTAC	CDC7_up_check_R: 5' GGAAAGTCCCTATTGGCGTTAC 3'
CDC7_up_check_R	GGAAAGTCCCTATTGGCGTTAC	CDC7_up_check_R 5' GGAAAGTCCCTATTGGCGTTAC 3'
Nestin	GGAACATGAATCTGTGGGTG	Nestin N f GGAACATGAATCTGTGGGTG
Tub/Tomato-4649:5'	GGAACCACAGAAAGCCACAT	Tub/Tomato-4649:5' - GGAACCACAGAAAGCCACAT -
chic2	GGAACCTGCTCTTGTTCCTG	chic2 5'-GGAACCTGCTCTTGTTCCTG-3'
4th	GGAACTGCAAGGAGCAGAAG	4th peak r5 5' GGAACTGCAAGGAGCAGAAG 3'
kdr_double	GGAAGAAGCACTAACCATTGAGA	kdr_double gRNA_check_R 5' GGAAGAAGCACTAACCATTGAGA 3'
Trim71R	GGAAGGTAAATGGGCTCACA	Trim71R 5'-GGAAGGTAAATGGGCTCACA-3'
D3S1763R	GGAAGGTGCGTATGAATGAG	D3S1763R    GGAAGGTGCGTATGAATGAG
hi-c_opistorchus_1	GGAAGTGTGTTCGGGGTAGA	hi-c_opistorchus_1  5'-GGAAGTGTGTTCGGGGTAGA
4C_primerHind_9_F	GGACACAGCAGATGATTTGC	4C_primerHind_9_F   5' GGACACAGCAGATGATTTGC 3'
Univ_806R	GGACTACCAGGGTATCTAAT	Univ_806R  GGACTACCAGGGTATCTAAT
Clon-loxpPuro-F	GGACTCCTcacgtggcggccgcttccgatcatattcaat	Clon-loxpPuro-F        5'-GGACTCCTcacgtggcggccgcttccgatcatattcaat-3'
Clon-loxpPuro-F	GGACTCCTcacgtggcggccgcttccgatcatattcaat	Clon-loxpPuro-F    5'-GGACTCCTcacgtggcggccgcttccgatcatattcaat-3'
Clon-loxpPuro-F	GGACTCCTcacgtgttcgaagcggccgcttccgatcatattcaat	Clon-loxpPuro-F    5'-GGACTCCTcacgtgttcgaagcggccgcttccgatcatattcaat-3'
5H-mm-F	GGACTCCTGGATCCGGGCAGAGAAGACAGTGAGG	5H-mm-F    GGACTCCTGGATCCGGGCAGAGAAGACAGTGAGG
5H-hs-F	GGACTCCTGGATCCTGCAGCCTGGGATC	5H-hs-F    GGACTCCTGGATCCTGCAGCCTGGGATC
3H-mm-F	GGACTCCTGGCGCGCCAAACTGCCCCTCTGGCACT	3H-mm-F    GGACTCCTGGCGCGCCAAACTGCCCCTCTGGCACT
3H-hs-F	GGACTCCTGGCGCGCCGAAAAGACCATCTGCCCGGCA	3H-hs-F    GGACTCCTGGCGCGCCGAAAAGACCATCTGCCCGGCA
D6Mit105R2:5'-CAAAAGCCTTATATATTACACCTCACC	GGACTCTTGATAACTGTGTTCTTTAGG	D6Mit105R2:5'-CAAAAGCCTTATATATTACACCTCACC           D10Mit104F2: 5'-GGACTCTTGATAACTGTGTTCTTTAGG
D6Mit105R2:5'-CAAAAGCCTTATATATTACACCTCACC	GGACTCTTGATAACTGTGTTCTTTAGG	D6Mit105R2:5'-CAAAAGCCTTATATATTACACCTCACC       D10Mit104F2: 5'-GGACTCTTGATAACTGTGTTCTTTAGG
D10Mit104F:	GGACTCTTGATAACTGTGTTCTTTAGG	D10Mit104F: 5'-GGACTCTTGATAACTGTGTTCTTTAGG
LTR3_2	GGACTGTACTGGGTCTCTCTGG	LTR3_2 5'-GGACTGTACTGGGTCTCTCTGG
20b	GGACTTTCCAGGTGGCACTA	20b  > q-aSpromR  5' GGACTTTCCAGGTGGCACTA   3'
qDlk1R	GGAGAGGGGTACTCTTGTTGAG	qDlk1R  GGAGAGGGGTACTCTTGTTGAG
hECAT15-1-S532	GGAGCCGCCTGCCCTGGAAAATTC	hECAT15-1-S532 GGA GCC GCC TGC CCT GGA AAA TTC
HNF3B_Mel_For	GGAGCGGTGAAGATGGAA	HNF3B_Mel_For    GGAGCGGTGAAGATGGAA
F:5'-	GGAGGTTGAGAGTTCTGGGC	F:5'- GGAGGTTGAGAGTTCTGGGC -
3C_BAC183_F2	GGAGTAGGGAAGAGGGGTTG	3C_BAC183_F2 5'-GGAGTAGGGAAGAGGGGTTG-3'
oTg3	GGAGTGCATCCACCACAATTTGA	oTg3 GGAGTGCATCCACCACAATTTGA 23b
Cdc_CheckPrimer_R	GGATGCTGTCACTGCTGTTC	Cdc_CheckPrimer_R   5' GGATGCTGTCACTGCTGTTC 3'
beta-3-tubulin	GGATTCGGTCCTGGATGTGG	beta-3-tubulin      F: GGATTCGGTCCTGGATGTGG
beta-3-tubulin	GGATTCGGTCCTGGATGTGG	beta-3-tubulin          F: GGATTCGGTCCTGGATGTGG
beta-3-tubulin	GGATTCGGTCCTGGATGTGG	beta-3-tubulin            F: GGATTCGGTCCTGGATGTGG
131	GGATTCTCCACCACCACCTC	131 GGATTCTCCACCACCACCTC
cSox2TanF	GGCAAAACCATCTCCGTG	cSox2TanF GGCAAAACCATCTCCGTG
Primer3	GGCAAGCTGCCCGTGCCcGGTTCACTAAACCAGCTCTGCT	Primer3 5'-GGCAAGCTGCCCGTGCCcGGTTCACTAAACCAGCTCTGCT
primer3	GGCAAGCTGCCCGTGCCcGGTTCACTAAACCAGCTCTGCT	primer3 GGCAAGCTGCCCGTGCCcGGTTCACTAAACCAGCTCTGCT
4C_primer	GGCAATAAAATGACTTTCAGCAG	4C_primer 4_R  5' GGCAATAAAATGACTTTCAGCAG 3'
qpcr_WPRE_F:	GGCACTGACAATTCCGTGGT	qpcr_WPRE_F: GGCACTGACAATTCCGTGGT
Smcx_Pr2	GGCAGAAGGAGCTCAAGTGT	Smcx_Pr2 5'-GGCAGAAGGAGCTCAAGTGT
AAVS1_genotip_P1:	GGCAGCCTGTGCTGACCCATGCAGTC	AAVS1_genotip_P1:        5'- GGCAGCCTGTGCTGACCCATGCAGTC-
AAVS1_genotip_P1:	GGCAGCCTGTGCTGACCCATGCAGTC	AAVS1_genotip_P1:    5'- GGCAGCCTGTGCTGACCCATGCAGTC-
Gibson_RING_F	ggcagcggaggaggaggatctggtggtggtggttccAAAATCTTAGAGTGTCCGATCTG	Gibson_RING_F    ggcagcggaggaggaggatctggtggtggtggttccAAAATCTTAGAGTGTCCGATCTG
qSOX2	GGCAGCTACAGCATGATGCAGGACC	qSOX2 f:  GGCAGCTACAGCATGATGCAGGACC
D3S2432F	GGCAGGCAGGTAGATAGACA	D3S2432F    GGCAGGCAGGTAGATAGACA
BAC_Smcx_	GGCATGTTGAGAAGCACAGA	BAC_Smcx_ 4   GGCATGTTGAGAAGCACAGA
GM9_5_F	GGCCCTTTTTCTCATCTACTCCTATT	GM9_5_F      5' GGCCCTTTTTCTCATCTACTCCTATT 3'
Primer	GGCCGCCACCACCTGTTCCTGggaagcggagccactaact	Primer F2 -GGCCGCCACCACCTGTTCCTGggaagcggagccactaact
tgfbr3_up_check_R	GGCCGCGACTCTAGATCATA	tgfbr3_up_check_R 5' GGCCGCGACTCTAGATCATA 3'
CNTN6_Ex7D_R	GGCCTGGTCATTGTCTCAGT	CNTN6_Ex7D_R    GGCCTGGTCATTGTCTCAGT
hcMycWangR	GGCCTTTTCATTGTTTTCCA	hcMycWangR GGCCTTTTCATTGTTTTCCA
TurboGFP	GGCGACTTCAAGGTGATGG	TurboGFP F 5'- GGCGACTTCAAGGTGATGG -
Tph2Int12_32:	ggcgcgccatcgactcaattgTAGAGAACACCGGAGACTGCCA	Tph2Int12_32: ggcgcgccatcgactcaattgTAGAGAACACCGGAGACTGCCA
hCNTN6i23_51	ggcgcgccCTCATAAACTCTTCTGCAGGTAA	hCNTN6i23_51 : ggcgcgccCTCATAAACTCTTCTGCAGGTAA
integProm_R	GGCGGAGTTGTTACGACATT	integProm_R GGCGGAGTTGTTACGACATT 20
MSX1_Mel_Rev	GGCGGCCATCTTCAGCTTCTCCAG	MSX1_Mel_Rev   GGCGGCCATCTTCAGCTTCTCCAG
Clon-GFP-F	GGCTAGCTGCCGGCACCGGTTGAAAGACCCCACCTGTAGGT	Clon-GFP-F   5'-GGCTAGCTGCCGGCACCGGTTGAAAGACCCCACCTGTAGGT-3'
Clon-3'longKO-F	GGCTAGCTGCGATCGCGTAAGTTTATGAAAATTAATGAACACTG	Clon-3'longKO-F GGCTAGCTGCGATCGCGTAAGTTTATGAAAATTAATGAACACTG
Clon-3short-F	GGCTAGCTGGATCCGCGATCGCGGCTGCTGCTTTTGCTATGCC	Clon-3short-F   5'-GGCTAGCTGGATCCGCGATCGCGGCTGCTGCTTTTGCTATGCC-3'
Clon-5short-F	GGCTAGCTGGTACCTGCATGAAAATTTCTGTTGGGTT	Clon-5short-F   5'-GGCTAGCTGGTACCTGCATGAAAATTTCTGTTGGGTT-3'
Clon-CMV-F	GGCTAGCTTCTAGACTCGAGCGATGTACGGGCCAGATATACGC	Clon-CMV-F   5'-GGCTAGCTTCTAGACTCGAGCGATGTACGGGCCAGATATACGC-3'
Clon-Puro-F	GGCTAGCTTGTACAATGACCGAGTACAAGCCCACGG	Clon-Puro-F   5'-GGCTAGCTTGTACAATGACCGAGTACAAGCCCACGG-3'
VPR-BsrGI-F	GGCTAGCTtgtacaCCGAAAAAGAAACGCAAAGTTGGTAGC	VPR-BsrGI-F    5-GGCTAGCTtgtacaCCGAAAAAGAAACGCAAAGTTGGTAGC-3
tgfbr_checkup_R	GGCTATGAACTAATGACCCCG	tgfbr_checkup_R   5'-GGCTATGAACTAATGACCCCG-3'
tlCMV_31	GGCTATGAACTAATGACCCCGT	tlCMV_31 : GGCTATGAACTAATGACCCCGT
CNTN6_Ex6D_R	GGCTCCACCAAACAAGAAGG	CNTN6_Ex6D_R    GGCTCCACCAAACAAGAAGG
D3S2406F	GGCTGGATGATCCACTTTAA	D3S2406F    GGCTGGATGATCCACTTTAA
tltkpA_51	GGCTGGCACTCTGTCGATAC	tltkpA_51 : GGCTGGCACTCTGTCGATAC
DsRed1_OlyaF	GGCTTCAAGTGGGAGCGCGT	DsRed1_OlyaF GGCTTCAAGTGGGAGCGCGT
Forward	GGCTTCAAGTGGGAGCGCGT	Forward primer GGCTTCAAGTGGGAGCGCGT Plus
3'-Molder-mid	GGCTTCAGCAGAGCGCAGATACCA	3'-Molder-mid GGCTTCAGCAGAGCGCAGATACCA
Clon-3'shortKO-F	GGCTttcgaaGTAAGTTTATGAAAATTAATGAACACTG	Clon-3'shortKO-F   5'-GGCTttcgaaGTAAGTTTATGAAAATTAATGAACACTG-3'
46_Brach_F2	ggctttggagaggtcaagga	46_Brach_F2   ggctttggagaggtcaagga
hSOX2MatF	GGGAAATGGGAGGGGTGCAAAAGAGG	hSOX2MatF GGGAAATGGGAGGGGTGCAAAAGAGG
Tub/Tomato-3750R:5'	GGGACCGTGGTTTCCTAAAT	Tub/Tomato-3750R:5' - GGGACCGTGGTTTCCTAAAT -
ESmmnestinGFP-IN-F	GGGACTGAAGCACTGGGAAG	ESmmnestinGFP-IN-F    GGGACTGAAGCACTGGGAAG
MycoVojdaniF	GGGAGCAAACAGGATTAGATACCCT	MycoVojdaniF    GGGAGCAAACAGGATTAGATACCCT
Cas9_33	GGGATCGAACCCTTTCACACCTT	Cas9_33 : GGGATCGAACCCTTTCACACCTT
NvKlf4R	GGGATGTACACTGGGTCCAA	NvKlf4R GGGATGTACACTGGGTCCAA
2nd	GGGCACCGCACAAACATAAC	2nd peak1F 5'-GGGCACCGCACAAACATAAC
Abcb4_51	GGGCACGGGTCCCTTGTAGCC	Abcb4_51 : 5-GGGCACGGGTCCCTTGTAGCC-3
Brn2+2AR:	gggccctgggttggactccacgtctcccgccaacttgagaaggtcaaaattcaaagtctgtttcacctggacgggcgtctgcaccccg	Brn2+2AR:   > 5' -gggccctgggttggactccacgtctcccgccaacttgagaaggtcaaaattcaaagtctgtttcacctggacgggcgtctgcaccccg-
tltkPA_54	GGGCCTTCACCCGAACTT	tltkPA_54 : GGGCCTTCACCCGAACTT
mGAPDH4	GGGCTTTTATAGCACGGTTATAAAGT	mGAPDH4 5'-GGGCTTTTATAGCACGGTTATAAAGT-3'
kdr_up_F	GGGGACAACTGGAGGACAAA	kdr_up_F    5' GGGGACAACTGGAGGACAAA 3'
c-kit_arm_down_R:	GGGGACAACTTTGTATAATAAAGTTGACCAGAAACCAAGTCCCAGC	c-kit_arm_down_R:     5' GGGGACAACTTTGTATAATAAAGTTGACCAGAAACCAAGTCCCAGC 3'
Tgfbr3_arm_up_F:	GGGGACAACTTTGTATAATAAAGTTGACCCAGGCTTGAGAATGCT	Tgfbr3_arm_up_F:   5' GGGGACAACTTTGTATAATAAAGTTGACCCAGGCTTGAGAATGCT 3'
Cdc7_arm_down_R:	GGGGACAACTTTGTATAATAAAGTTGAGCCTTATAATGGGTGGACTTAA	Cdc7_arm_down_R:  5'GGGGACAACTTTGTATAATAAAGTTGAGCCTTATAATGGGTGGACTTAA 3'
c-kit	GGGGACAACTTTGTATAATAAAGTTGaggaactctggtgcagaagg	c-kit down2r 5'-GGGGACAACTTTGTATAATAAAGTTGaggaactctggtgcagaagg-3'
Kdr_arm_up_F:	GGGGACAACTTTGTATAATAAAGTTGTACAACACTGGGTAGCTGGG	Kdr_arm_up_F:       5' GGGGACAACTTTGTATAATAAAGTTGTACAACACTGGGTAGCTGGG 3'
c-kit_arm_up_F:	GGGGACAACTTTGTATAGAAAAGTTGCACTGACCACCCATCCCATA	c-kit_arm_up_F:        5' GGGGACAACTTTGTATAGAAAAGTTGCACTGACCACCCATCCCATA 3'
tgfbr	GGGGACAACTTTGTATAGAAAAGTTGCCCCAGCCTAGTCTCACAAG	tgfbr down2r 5'-GGGGACAACTTTGTATAGAAAAGTTGCCCCAGCCTAGTCTCACAAG-3'
Kdr_arm_down_R:	GGGGACAACTTTGTATAGAAAAGTTGCTAACACAACCTGGGCACAC	Kdr_arm_down_R:     5' GGGGACAACTTTGTATAGAAAAGTTGCTAACACAACCTGGGCACAC 3'
Cdc7_arm_up_F:	GGGGACAACTTTGTATAGAAAAGTTGCTCCAGTGTGACCCATGACT	Cdc7_arm_up_F:        5' GGGGACAACTTTGTATAGAAAAGTTGCTCCAGTGTGACCCATGACT 3'
Tgfbr3_arm_down_R:	GGGGACAACTTTGTATAGAAAAGTTGGCAGGCTCTAGATGGTCCAT	Tgfbr3_arm_down_R:   5' GGGGACAACTTTGTATAGAAAAGTTGGCAGGCTCTAGATGGTCCAT 3'
Cdc7_arm_down_F:	GGGGACAGCTTTCTTGTACAAAGTGGATCTTACACAGGACACTTCT	Cdc7_arm_down_F:     5' GGGGACAGCTTTCTTGTACAAAGTGGATCTTACACAGGACACTTCT 3'
Tgfbr3_arm_up_R:	GGGGACAGCTTTCTTGTACAAAGTGGCCCAAATAATGGTTTTCACTCAG	Tgfbr3_arm_up_R:  5' GGGGACAGCTTTCTTGTACAAAGTGGCCCAAATAATGGTTTTCACTCAG 3'
Kdr_arm_up_R:	GGGGACAGCTTTCTTGTACAAAGTGGTGTCACTGTGGAATCCCAAACT	Kdr_arm_up_R:      5'  GGGGACAGCTTTCTTGTACAAAGTGGTGTCACTGTGGAATCCCAAACT 3'
c-kit_arm_down_F:	GGGGACAGCTTTCTTGTACAAAGTGGTTCATCTACGGGCTCTGCTTC	c-kit_arm_down_F:     5' GGGGACAGCTTTCTTGTACAAAGTGGTTCATCTACGGGCTCTGCTTC 3'
12_Hprt_ex6_51	GGGGACTGACATTACCTCTGC	12_Hprt_ex6_51  GGGGACTGACATTACCTCTGC
c-kit_arm_up_R:	GGGGACTGCTTTTTTGTACAAACTTGAGGCTACTGAGCAATTCGTG	c-kit_arm_up_R:       5' GGGGACTGCTTTTTTGTACAAACTTGAGGCTACTGAGCAATTCGTG 3'
Tgfbr3_arm_down_F:5'	GGGGACTGCTTTTTTGTACAAACTTGCGTCCCTGAGCTAGGAAATTAG	Tgfbr3_arm_down_F:5' GGGGACTGCTTTTTTGTACAAACTTGCGTCCCTGAGCTAGGAAATTAG 3'
Cdc7_arm_up_R:	GGGGACTGCTTTTTTGTACAAACTTGGATAATGGCACGGAACACAG	Cdc7_arm_up_R:        5' GGGGACTGCTTTTTTGTACAAACTTGGATAATGGCACGGAACACAG 3'
Kdr_arm_down_F:	GGGGACTGCTTTTTTGTACAAACTTGGCTGTCAGAGGCCCAACTTT	Kdr_arm_down_F:       5' GGGGACTGCTTTTTTGTACAAACTTGGCTGTCAGAGGCCCAACTTT 3'
30_gibbsBrach52	GGGGGAGGATTGGGAAGACAAGGCCTGGAGGAGAGCGA	30_gibbsBrach52 GGGGGAGGATTGGGAAGACAA GGCCTGGAGGAGAGCGA -
30_gibbsBrach52	GGGGGAGGATTGGGAAGACAAGGCCTGGAGGAGAGCGA	30_gibbsBrach52 GGGGGAGGATTGGGAAGACAA GGCCTGGAGGAGAGCGA
103	GGGGTGGGGAGATGAGTAGA	103         GGGGTGGGGAGATGAGTAGA
3C-F18_-6	GGGTAATTCTGAGGGCTGCATAG	3C-F18_-6    GGGTAATTCTGAGGGCTGCATAG
ESmmnestinGFP-IN-R	GGGTACCCAAATGTTGAGGC	ESmmnestinGFP-IN-R      GGGTACCCAAATGTTGAGGC
106	GGGTCACAATTTTGGAGCACA	106         GGGTCACAATTTTGGAGCACA
4C_primer	GGGTCCAAGTCTTTCAAGCTT	4C_primer 9_F   5' GGGTCCAAGTCTTTCAAGCTT 3'
D3S2387R	GGGTGACAGAGTGAGATGTG	D3S2387R    GGGTGACAGAGTGAGATGTG
CNTN6_Ex21D_R	GGGTGTCACATGTTTCATTCCT	CNTN6_Ex21D_R  GGGTGTCACATGTTTCATTCCT
CMV511	GGTAAATGGCCCGCCTGGCA	CMV511 : GGTAAATGGCCCGCCTGGCA
humanOLIG2:	GGTAAGTGCGCAATGCTAAGCTGT	humanOLIG2:           F: GGTAAGTGCGCAATGCTAAGCTGT
humanOLIG2:	GGTAAGTGCGCAATGCTAAGCTGT	humanOLIG2:             F: GGTAAGTGCGCAATGCTAAGCTGT
humanOLIG2:	GGTAAGTGCGCAATGCTAAGCTGT	humanOLIG2:       F: GGTAAGTGCGCAATGCTAAGCTGT
qTuj1_31	GGTACTCCTCACGCACCTTGCT	qTuj1_31 :GGT ACT CCT CAC GCA CCT TGCT
SOX1_Mel_Rev	GGTACTTGTAATCCGGGTGC	SOX1_Mel_Rev    GGTACTTGTAATCCGGGTGC
2_bottom	GGTAGACCCCTCCTCCACAGTGGt	2_bottom 5'-GGTAGACCCCTCCTCCACAGTGGt-3'
RT-mCNBD1-3-R	GGTAGGTCCACAAGTCCAACAA	RT-mCNBD1-3-R        5' GGTAGGTCCACAAGTCCAACAA 3'
MpfGAPDHR	ggtcatgagtccctccacaa	MpfGAPDHR ggtcatgagtccctccacaa
kdr_down_R	GGTCCCCAACCTGAGAACAG	kdr_down_R    5' GGTCCCCAACCTGAGAACAG 3'
Brachyury_OlyaR:	GGTCTCGGGAAAGCAGTGGC	Brachyury_OlyaR: GGTCTCGGGAAAGCAGTGGC
mCNTN5-RT-Ex5_F	GGTCTTCAATGAGTTCCCTTCCT	mCNTN5-RT-Ex5_F      5' GGTCTTCAATGAGTTCCCTTCCT 3'
chickHi-C1	GGTCTTTGTGGTCCCTTTCA	chickHi-C1 5'-GGTCTTTGTGGTCCCTTTCA-3'
DsRed1R	GGTGATGTCCAGCTTGGAGT	DsRed1R    GGTGATGTCCAGCTTGGAGT
NvOct4e5R	GGTGCCAGAGGAAAGGAT	NvOct4e5R GGTGCCAGAGGAAAGGAT
FABP-human	GGTGGAGGCTTTCTGTGCTA	FABP-human        F-GGTGGAGGCTTTCTGTGCTA
TKA_pA31	GGTGGGGTATCGACAGAGTG	TKA_pA31 GGTGGGGTATCGACAGAGTG
128	GGTGTCCCATGTCACTGAATC	128 GGTGTCCCATGTCACTGAATC
GM9_3_F	GGTGTGCTGTGTGGATGCTA	GM9_3_F 5' GGTGTGCTGTGTGGATGCTA 3'
TurboGFP	GGTGTTGCTGTGATCCTCCTC	TurboGFP R 5'- GGTGTTGCTGTGATCCTCCTC -
D3S1768F	GGTTGCTGCCAAAGATTAGA	D3S1768F    GGTTGCTGCCAAAGATTAGA
3-GM9-conf	GGTTTGGTCTTCTCATTGTGTCCTG	3-GM9-conf GGTTTGGTCTTCTCATTGTGTCCTG
Short	GGTTTTGGGATAGGCAGTGGAG	Short F 5'- GGTTTTGGGATAGGCAGTGGAG -
M13_F:	GTAAAACGACGGCCAGT	M13_F:  5' GTAAAACGACGGCCAGT  3'
M13F	GTAAAACGACGGCCAGT	M13F GTAAAACGACGGCCAGT
BAC_Smcx_2	GTAACAGCAAGAGCAGCAGC	BAC_Smcx_2   GTAACAGCAAGAGCAGCAGC
Csn1s1-end-F	GTAACTCTGGCCCTTGGGATTT	Csn1s1-end-F      5' GTAACTCTGGCCCTTGGGATTT 3'
SOX	GTAACTGTCCATGCGCTG	SOX Rev: 5' - GTAACTGTCCATGCGCTG
clon_LTB_R	GTAAGTCATTGGTCTTAAAGGCTAGATTCCTGGAAGCATT	clon_LTB_R : GTAAGTCATTGGTCTTAAAGGCTAGATTCCTGGAAGCATT
TAF3_del1_F	GTAATCAGAAATCTGAAGACATGC	TAF3_del1_F    GTAATCAGAAATCTGAAGACATGC
Tgfbr3-B_R:	gtacaagaaagctgggtACCCAGGCTTGAGAATGC	Tgfbr3-B_R: 5' gtacaagaaagctgggtACCCAGGCTTGAGAATGC  3'
kdr_down_R	gtacaagaaagctgggtGGTCCCCAACCTGAGAACAG	kdr_down_R    5'gtacaagaaagctgggtGGTCCCCAACCTGAGAACAG 3'
Kdr_B_R	gtacaagaaagctgggtTACAACACTGGGTAGCTG	Kdr_B_R  5' gtacaagaaagctgggtTACAACACTGGGTAGCTG 3'
tgfbr_DOWN_R	gtacaagaaagctgggtTTCCATGGCTTTGTGTATAAGTTC	tgfbr_DOWN_R 5'-gtacaagaaagctgggtTTCCATGGCTTTGTGTATAAGTTC-3'
C-kit_B_R	gtacaagaaagctgggtTTTGGCTCCATCGTTATTC	C-kit_B_R  5' gtacaagaaagctgggtTTTGGCTCCATCGTTATTC 3'
D3S2418F	GTACATTCTGCACACGTACCC	D3S2418F    GTACATTCTGCACACGTACCC
LD-G7-F:	GTACCTTCATGTCTGCTGTCTGGTT	LD-G7-F:  GTACCTTCATGTCTGCTGTCTGGTT
3'-Molder-inn	GTAGCACCGCCTACATACCTCGCT	3'-Molder-inn GTAGCACCGCCTACATACCTCGCT
IntCont_oIMR7339:	GTAGGTGGAAATTCTAGCATCATCC	IntCont_oIMR7339:  GTAGGTGGAAATTCTAGCATCATCC
IntCont_oIMR7339:	GTAGGTGGAAATTCTAGCATCATCC	IntCont_oIMR7339: GTAGGTGGAAATTCTAGCATCATCC
CNTN6_Ex16D_F	GTAGTCCCAACCTAGGTGCC	CNTN6_Ex16D_F  GTAGTCCCAACCTAGGTGCC
4C_primerDpn_9_R	GTAGTTGAAGGACGAAGCTT	4C_primerDpn_9_R   5' GTAGTTGAAGGACGAAGCTT 3'
mtDNA_Pr5	gtatgcacgcgatagcattgc	mtDNA_Pr5 gtatgcacgcgatagcattgc
Foxa2_OlyaF	GTATGCTGGGAGCCGTGGC	Foxa2_OlyaF       GTATGCTGGGAGCCGTGGC
Foxa2	GTATGCTGGGAGCCGTGGC	Foxa2 F: GTATGCTGGGAGCCGTGGC
Foxa2_OlyaF:	GTATGCTGGGAGCCGTGGC	Foxa2_OlyaF: GTATGCTGGGAGCCGTGGC
1st	GTCACAGATTTCCAGGCAACG	1st peak checkR 5'-GTCACAGATTTCCAGGCAACG-3'
GM9_4_F	GTCACCTCCCCAGACACAAC	GM9_4_F 5' GTCACCTCCCCAGACACAAC 3'
RNF169F	gtcacgggtaccgatggcggctgcaggtccgag	RNF169F   5'-gtcacgggtaccgatggcggctgcaggtccgag
Tph25UTR_51	gtcatgccagcagaaaagcc	Tph25UTR_51 : gtcatgccagcagaaaagcc
rbbp8f	gtcatgggtaccgatgaacatctcgggaagcag	rbbp8f 5'-gtcatgggtaccgatgaacatctcgggaagcag
F:5'-GTCAACCTGGGTTTTGCCAC-3'	GTCCAGCAGCTCTTGTTCCT	F:5'-GTCAACCTGGGTTTTGCCAC-3'    Mash1.R:5'-GTCCAGCAGCTCTTGTTCCT-3'
F:5'-GTCAACCTGGGTTTTGCCAC-3'	GTCCAGCAGCTCTTGTTCCT	F:5'-GTCAACCTGGGTTTTGCCAC-3'        Mash1.R:5'-GTCCAGCAGCTCTTGTTCCT-3'
qpcr_GFP_F	GTCCAGGAGCGCACCATCT	qpcr_GFP_F : GTCCAGGAGCGCACCATCT
PAX6_Mel_For	GTCCATCTTTGCTTGGGAAA	PAX6_Mel_For    GTCCATCTTTGCTTGGGAAA
RT-GCSF-F	GTCCCACCTTGGACACACTG	RT-GCSF-F   5'- GTCCCACCTTGGACACACTG -3'
qCas9R	GTCCCGTTGATTTTGGTGCC	qCas9R : GTCCCGTTGATTTTGGTGCC
CNTN6_Ex23D2_F	GTCCTTGGACAAAGACACGGT	CNTN6_Ex23D2_F    GTCCTTGGACAAAGACACGGT
c-myc-down	gtcgttgtagcgatctgcacgtgatactagacttaaggc	c-myc-down 5'-gtcgttgtagcgatctgcacgtgatactagacttaaggc-3'
ESmmnestinGFP-OUT-F	GTCTACAGGCAGCGCTAACA	ESmmnestinGFP-OUT-F      GTCTACAGGCAGCGCTAACA
MinkNanog155F	GTCTCCTCTTCCTTCCTCCG	MinkNanog155F   GTCTCCTCTTCCTTCCTCCG
GM_RNA_R	GTCTGTAGGCAGGTCGGCTC	GM_RNA_R GTCTGTAGGCAGGTCGGCTC 20
integOri_R	GTCTTACCGGGTTGGACTCA	integOri_R GTCTTACCGGGTTGGACTCA 20
138	GTGAATATACGGACGTTTGTCTCCA	138 GTGAATATACGGACGTTTGTCTCCA
F:5'-	gtgacatccgtccaggagggcagaggaagtctgctaacatgcggtgacgtcgaggagaatcctggcccaatggagagctcatttaaatgactcatgtcgt	F:5'-  > gtgacatccgtccaggagggcagaggaagtctgctaacatgcggtgacgtcgaggagaatcctggcccaatggagagctcatttaaatgactcatgtcgt
AGGGCGAAGAAAACCGCATC	GTGACTTTTTGGCCTTCCCC	AGGGCGAAGAAAACCGCATC    GFAP.R: GTGACTTTTTGGCCTTCCCC
GFP_51	GTGAGCAAGGGCGAGGAG	GFP_51 GTGAGCAAGGGCGAGGAG
1st	GTGAGGTTGTGAGGCCAGTT	1st peak check f2 5' GTGAGGTTGTGAGGCCAGTT 3'
D21S11F:	GTGAGTCAATTCCCCAAG	D21S11F: GTGAGTCAATTCCCCAAG
CNTN6_Ex18D_F	GTGATTGATCACATTCTGCCCA	CNTN6_Ex18D_F  GTGATTGATCACATTCTGCCCA
EScaseinGM_5H_R	GTGCAGAGATGCTGCAGGC	EScaseinGM_5H_R  5' GTGCAGAGATGCTGCAGGC 3'
EScaseinGM_5H_R	GTGCAGAGATGCTGCAGGC	EScaseinGM_5H_R    GTGCAGAGATGCTGCAGGC
EScaseinGM_5H_R	GTGCAGAGATGCTGCAGGC	EScaseinGM_5H_R      5' GTGCAGAGATGCTGCAGGC 3'
mtDNA_Pr7	gtgcagccgctattaaaggtt	mtDNA_Pr7 gtgcagccgctattaaaggtt
hGDF3-AS850	GTGCCAACCCAGGTCCCGGAAGTT	hGDF3-AS850 GTG CCA ACC CAG GTC CCG GAA GTT
CNTN6_Ex3D_R	GTGCCCACAGGTAGGATTTT	CNTN6_Ex3D_R    GTGCCCACAGGTAGGATTTT
4th	GTGCTATGGGAGCCGAAAGA	4th peak R_3   5' GTGCTATGGGAGCCGAAAGA 3'
5'-GGAGGTTCGCCGTGTACTAA-3'	GTGCTCAAGGCATTCTCCAT	5'-GGAGGTTCGCCGTGTACTAA-3'  > qIGDMR(HhaI)-R 5'-GTGCTCAAGGCATTCTCCAT-3'
4C_primer	GTGCTGTGTCGTACAAGCTT	4C_primer 8_F   5' GTGCTGTGTCGTACAAGCTT 3'
Clon-5H-RPLCMNT-R	GTGGCCTAGGCACAGGCCCA	Clon-5H-RPLCMNT-R    GTGGCCTAGGCACAGGCCCA
NESTIN-human	GTGGCTCCAAGACTTCCCTC	NESTIN-human      F-GTGGCTCCAAGACTTCCCTC
H-b-ACT:	GTGGGGCGCCCCAGGCACCA	H-b-ACT:    F-GTGGGGCGCCCCAGGCACCA
PrF_gkdr1_AflII	gtggtacttaagGAAGAGGGCCTATTTC	PrF_gkdr1_AflII gtggtacttaagGAAGAGGGCCTATTTC
GM9_2_F	GTGTTGAAGGCTCCCACTGT	GM9_2_F  5' GTGTTGAAGGCTCCCACTGT 3'
P4_F1:	GTTCAACTTTtcTaTACAAAGTTG	P4_F1: 5' GTTCAACTTTtcTaTACAAAGTTG 3'
P1R_F1:	GTTCAACTTTtTTgTACAAAGTTG	P1R_F1: 5' GTTCAACTTTtTTgTACAAAGTTG 3'
bTubb3_qPCR_R	GTTCCAGGTTCCAAGTCCACC	bTubb3_qPCR_R    GTTCCAGGTTCCAAGTCCACC
3'-uoTg-2	GTTCCCTTTCTAGTGGTGGAAACTTCCC	3'-uoTg-2 GTTCCCTTTCTAGTGGTGGAAACTTCCC
hFGF4-RT-L	GTTGCACCAGAAAAGTCAGAGTTG	hFGF4-RT-L GTT GCA CCA GAA AAG TCA GAG TTG
D21S11R:	GTTGTATTAGTCAATGTTCTCC	D21S11R: GTTGTATTAGTCAATGTTCTCC
BAC_Smcx_8	GTTTCCCATCGCTAAAACGA	BAC_Smcx_8   GTTTCCCATCGCTAAAACGA
Gm11867-RT-2-R	GTTTGGTTGGTGCTGTAAGGTAC	Gm11867-RT-2-R      5' GTTTGGTTGGTGCTGTAAGGTAC 3'
Gm11867-RT-2-R	GTTTGGTTGGTGCTGTAAGGTAC	Gm11867-RT-2-R          5' GTTTGGTTGGTGCTGTAAGGTAC 3'
SchicMbo_check2	GTTTTACGGCTGGACGGGTA	SchicMbo_check2 5'-GTTTTACGGCTGGACGGGTA-3'
clon_LTB_F	Gttttccagtcacacctcagaaagactggatgacagcaaa	clon_LTB_F : Gttttccagtcacacctcagaaagactggatgacagcaaa
humanSox1:	GTTTTTTGTAGTTGTTACCGC	humanSox1:      F: GTTTTTTGTAGTTGTTACCGC
humanSox1:	GTTTTTTGTAGTTGTTACCGC	humanSox1:            F: GTTTTTTGTAGTTGTTACCGC
humanSox1:	GTTTTTTGTAGTTGTTACCGC	humanSox1:          F: GTTTTTTGTAGTTGTTACCGC
CATCTTCTTCCTCTCCCTCTT	nTCCTGCTGATTCCGAATG	CATCTTCTTCCTCTCCCTCTT    Transferrin TCCTGCTGATTCCGAATG
down_gfp-DR-tomato_olig	TAAAACCGAGTTCGAGATCGAGGGCGAGGGCGAGGGGTTTTGGGACCATTCAAAACAGCATAGCTCTAAAACCCGGCAAGCTGCCCGTGCCCTGGCCCACCC	down_gfp-DR-tomato_olig       5'-TAAAACCGAGTTCGAGATCGAGGGCGAGGGCGAGGGGTTTTGGGACCATTCAAAACAGCATAGCTCTAAAACCCGGCAAGCTGCCCGTGCCCTGGCCCACCC-3'
3C_Anopheles_1F	TAAACAAAATGCGACGGTCA	3C_Anopheles_1F   5' TAAACAAAATGCGACGGTCA 3'
Barcode	taacatgtCAGGAAACAGCTATGACC	Barcode olig (EcoRI-PciI)2 5'-taacatgtCAGGAAACAGCTATGACC-3'
mtDNA_Pr2	taaccctcaacacccactcc	mtDNA_Pr2 taaccctcaacacccactcc
T7+Cas9_52	TAATACGACTCACTATAGGGAGAGCCACCATGGACAAGAAGTACTCCA	T7+Cas9_52 : TAATACGACTCACTATAG GGAGA GCCACCATGGACAAGAAGTACTCCA
20_T7+Cas9+GFP_51:	TAATACGACTCACTATAGGGCGGTGCCACCATGGACTA	20_T7+Cas9+GFP_51:     5' TAATACGACTCACTATAGGGCGGTGCCACCATGGACTA 3'
T7+gReGFP	TAATACGACTCACTATAGGGGCACGGGCAGCTTGCC	T7+gReGFP : TAATACGACTCACTATAGGGGCACGGGCAGCTTGCC
T7+ATGcasein_gRNA	TAATACGACTCACTATAGGgtgaggatgaggagtttca	T7+ATGcasein_gRNA      5'-TAATACGACTCACTATAGGgtgaggatgaggagtttca-3'
34_T7+GFP-621_51	TAATACGACTCACTATAGGGttcggcatggtgagcaagg	34_T7+GFP-621_51     TAATACGACTCACTATAGGGttcggcatggtgagcaagg
D5Mit208R	TAATCACATGGCTTCTGGCA	D5Mit208R  TAATCACATGGCTTCTGGCA
LvSeqR	taatccagaggttgattatcatatgactag	LvSeqR 5-taatccagaggttgattatcatatgactag-3
71_bottom	TAATGGCACGGAACACAGGATGGt	71_bottom 5'-TAATGGCACGGAACACAGGATGGt-3'
gRNA1_kdr_R	TACAAGAAAGCTGGGTCTAGAAAAAAAGCACCGACTCGGT	gRNA1_kdr_R    5' TACAAGAAAGCTGGGTCTAGAAAAAAAGCACCGACTCGGT 3'
5_tail_REV_4	TACCAAGATCATCACCGACTGCCCATAGAGAGG	5_tail_REV_4   TACCAAGATCATCACCGACTGCCCATAGAGAGG
105	TACCCTGCAGGTATCCCACA	105         TACCCTGCAGGTATCCCACA
5H-DT1-mm-F	taccgagctcGGATCCGGGCAGAGAAGACAGTGAGG	5H-DT1-mm-F       taccgagctcGGATCCGGGCAGAGAAGACAGTGAGG
gRNA2_kdr_Gibson_R	TACCGTAAGTTATGTAACGGTACAAGAAAGCTGGGTCTAG	gRNA2_kdr_Gibson_R    5' TACCGTAAGTTATGTAACGGTACAAGAAAGCTGGGTCTAG 3'
kdr_down_T-vector_F	tacctcgcgaatgcatGGTCCCCAACCTGAGAAC	kdr_down_T-vector_F  5' tacctcgcgaatgcatGGTCCCCAACCTGAGAAC  3'
NvSox2F	TACCTCTTCCTCCCACTCCA	NvSox2F TACCTCTTCCTCCCACTCCA
CCACCAGACTCACCTGACAC	TACGGGGCTCTGAGAACTGG	CCACCAGACTCACCTGACAC    Pax6.R: TACGGGGCTCTGAGAACTGG
HNF3B_Mel_Rev	TACGTGTTCATGCCGTTCAT	HNF3B_Mel_Rev   TACGTGTTCATGCCGTTCAT
EScaseinGM_5H_2_R	TACTCAGGTTCAGGAGACGCC	EScaseinGM_5H_2_R      5' TACTCAGGTTCAGGAGACGCC 3'
EScaseinGM_5H_2_R	TACTCAGGTTCAGGAGACGCC	EScaseinGM_5H_2_R          5' TACTCAGGTTCAGGAGACGCC 3'
Barcode	tactcgagCAGGAAACAGCTATGACC	Barcode olig1 5'-tactcgagCAGGAAACAGCTATGACC-3'
RT-mCNBD1-1-R	TAGAAGGGCCACCACGAGCTTC	RT-mCNBD1-1-R      5' TAGAAGGGCCACCACGAGCTTC 3'
bTubb3_qPCR_F	TAGACCCCAGCGGCAACTAT	bTubb3_qPCR_F    TAGACCCCAGCGGCAACTAT
F:5'-	tagaccgcagcgtcgaattcaggtcgtgaaacagactttgaattttgaccttctcaagttggcgggagacgtggagtccaacccagggcccatggcgaccgcagcgtc	F:5'-  > tagaccgcagcgtcgaattcaggtcgtgaaacagactttgaattttgaccttctcaagttggcgggagacgtggagtccaacccagggcccatggcgaccgcagcgtc
CNTN6_Ex3D_F	TAGACTTGCATTCAAAACAGGGC	CNTN6_Ex3D_F    TAGACTTGCATTCAAAACAGGGC
Sox2_Takahashi_F:	TAGAGCTAGACTCCGGGCGATGA	Sox2_Takahashi_F:  TAGAGCTAGACTCCGGGCGATGA
PRODH	TAGATCTTTTGAGAAGCCAGTGGGCCTTG	PRODH R: 5' - TAGATCTTTTGAGAAGCCAGTGGGCCTTG -
TAF4_dupIN1_F	TAGATGGAGGTTCCCCCACA	TAF4_dupIN1_F    TAGATGGAGGTTCCCCCACA
CNTN6_Ex11D2_F	TAGCATAGCAAGTCACCCCTG	CNTN6_Ex11D2_F   TAGCATAGCAAGTCACCCCTG
PAX6_Mel_Rev	TAGCCAGGTTGCGAAGAACT	PAX6_Mel_Rev    TAGCCAGGTTGCGAAGAACT
mtDNA_Pr8	tagccccctttcacttctgag	mtDNA_Pr8 tagccccctttcacttctgag
TEasyBamhIRev	TAGGATCCGCGATATCACTAGTG	TEasyBamhIRev   5'-TAGGATCCGCGATATCACTAGTG-3'
mCNTN5-RT-Ex22_F	TAGGGAGCCACCTGGCAACC	mCNTN5-RT-Ex22_F      5' TAGGGAGCCACCTGGCAACC 3'
q-mOct4F	TAGGTGAGCCGTCTTTCCAC	q-mOct4F  TAGGTGAGCCGTCTTTCCAC  20b
hSOX17-AS583	TAGTTGGGGTGGTCCTGCATGTGCTG	hSOX17-AS583  TAG TTG GGG TGG TCC TGC ATG TGC TG
4C_primer	TATAATGTGCCCTGCTGTGGT	4C_primer 9_R   5' TATAATGTGCCCTGCTGTGGT 3'
bsIGCr2	TATACACAAAAATATATCTATATAACACCATACAA	bsIGCr2 5'-TAT ACA CAA AAA TAT ATC TAT ATA ACA CCA TAC AA-3'
2-GRE-mut-AS	TATAGGAAATGGAATGGCATTCATGTAAATTAACATCCAAAA	2-GRE-mut-AS TATAGGAAATGGAATGGCATTCATGTAAATTAACATCCAAAA
mGAPDH3	TATCAAGGGTGCCCGTCACCTTCAGC	mGAPDH3 5'-TATCAAGGGTGCCCGTCACCTTCAGC-3'
R:5'	TATCATATGTCGTGGGGCGG	R:5' - TATCATATGTCGTGGGGCGG -
D2Mit285R	TATGACACTTACAAGGTTTTTGGTG	D2Mit285R  5'-TATGACACTTACAAGGTTTTTGGTG-3'
Rex1R	TATGACTCACTTCCAGGGGGCACT	Rex1R 5-TATGACTCACTTCCAGGGGGCACT-3
GMCSF-R-gibson	tattaagggttattgaatatgatcggaattctcactcctggactggctccca	GMCSF-R-gibson              5'-tattaagggttattgaatatgatcggaattctcactcctggactggctccca-3'
GMCSF-R-gibson	tattaagggttattgaatatgatcggaattctcactcctggactggctccca	GMCSF-R-gibson    5'-tattaagggttattgaatatgatcggaattctcactcctggactggctccca-3'
GMCSF-R-gibson	tattaagggttattgaatatgatcggaattctcactcctggactggctccca	GMCSF-R-gibson                  5'-tattaagggttattgaatatgatcggaattctcactcctggactggctccca-3'
GMCSF-R-gibson	tattaagggttattgaatatgatcggaattctcactcctggactggctccca	GMCSF-R-gibson          5'-tattaagggttattgaatatgatcggaattctcactcctggactggctccca-3'
qSyn1_51	TATTGAGGTGGTGGGCTCCT	qSyn1_51 TATTGAGGTGGTGGGCTCCT
cSox2TanR	TCAAATAATACAGAGCCGAATC	cSox2TanR TCAAATAATACAGAGCCGAATC
42_g1chr15cut2LF2:	TCAACATTCAGGGCCCCATC	42_g1chr15cut2LF2: TCAACATTCAGGGCCCCATC
MicePeg3OF	TCAACCTTATCAATTACCCTTAAAAACC	MicePeg3OF  > >> 5'-TCAACCTTATCAATTACCCTTAAAAACC-3'
MicePeg3OF	TCAACCTTATCAATTACCCTTAAAAACC	MicePeg3OF  > 5'-TCAACCTTATCAATTACCCTTAAAAACC-3'
5'-3'	TCAAGAGGCGAACACACAAC	5'-3'    hcMycWangF TCAAGAGGCGAACACACAAC
D2Mit285F	TCAATCCCTGTCTGTGGTAGG	D2Mit285F  5'-TCAATCCCTGTCTGTGGTAGG-3'
Cas9_31	TCACACCTTCCTCTTCTTCTTGG	Cas9_31  TCACACCTTCCTCTTCTTCTTGG
Clon-Tomato-R	tcacttgtacagctcgtccatgc	Clon-Tomato-R      tcacttgtacagctcgtccatgc
PuroCsonka2000R	TCAGGCACCGGGCTTGCGGGTCATGCA	PuroCsonka2000R primer 5'-TCAGGCACCGGGCTTGCGGGTCATGCA
Seq_gibson_ring_R	TCATAGCGCGGGTTCCTTCC	Seq_gibson_ring_R      5' TCATAGCGCGGGTTCCTTCC 3'
CNTN6_Ex22D_R	TCATGCTGCAGCTGTCTAGG	CNTN6_Ex22D_R  TCATGCTGCAGCTGTCTAGG
118	TCCAAGACCTTCCCTTCCAC	118 TCCAAGACCTTCCCTTCCAC
D3S2436F	TCCAATCTCATCCAGGTTTC	D3S2436F    TCCAATCTCATCCAGGTTTC
hKLF4MatR	TCCACTCACAAGATGACTCAGT	hKLF4MatR TCCACTCACAAGATGACTCAGT
CNTN6_Ex22D_F	TCCAGAACAGTTGTGTGAACCT	CNTN6_Ex22D_F  TCCAGAACAGTTGTGTGAACCT
CNTN6_Ex22D2_F	TCCAGAACAGTTGTGTGAACCTT	CNTN6_Ex22D2_F    TCCAGAACAGTTGTGTGAACCTT
1272H	TCCAGAATATCTTCTGCTCC	1272H 5'-TCCAGAATATCTTCTGCTCC-3'
genotip_AAVS_F	TCCAGGGGTCCGAGAGCTCAGCTAG	genotip_AAVS_F    5'- TCCAGGGGTCCGAGAGCTCAGCTAG -3'
CNTN6_Ex14D2_F	TCCATTTCTCCCTTTCTGTCTGC	CNTN6_Ex14D2_F  TCCATTTCTCCCTTTCTGTCTGC
115	TCCCCATCTGCTGGCTCTAT	115 TCCCCATCTGCTGGCTCTAT
D3S1764F	TCCCCTTTGAAAGTCCTACC	D3S1764F    TCCCCTTTGAAAGTCCTACC
D3S1764R	TCCCTGGGTGAAAATGAGTA	D3S1764R    TCCCTGGGTGAAAATGAGTA
Abcb4_31	TCCCTTCCCCCTACATCTCCCGT	Abcb4_31 : 5-TCCCTTCCCCCTACATCTCCCGT-3
qCDKI2A	TCCGCGATACAACCTTCCTAA	qCDKI2A r: TCCGCGATACAACCTTCCTAA
cNANOG197R	TCCGGGCTGTCCTGAGTAAG	cNANOG197R  TCCGGGCTGTCCTGAGTAAG
5_tail_REV_11	TCCTCGAATCATCACCGACTGCCCATAGAGAGG	5_tail_REV_11 TCCTCGAATCATCACCGACTGCCCATAGAGAGG
tgfbr3_TaqI_check_F	TCCTCGCTCTCAACCAGAAT	tgfbr3_TaqI_check_F   3' TCCTCGCTCTCAACCAGAAT 5'
tgfbr3_TaqI_check_F	TCCTCGCTCTCAACCAGAAT	tgfbr3_TaqI_check_F   5' TCCTCGCTCTCAACCAGAAT 3'
CTGAAGATCCTGGAGACCAT	TCCTCTCTCCCATAATGCAG	CTGAAGATCCTGGAGACCAT                    Zbtb16.R: TCCTCTCTCCCATAATGCAG
CTGAAGATCCTGGAGACCAT	TCCTCTCTCCCATAATGCAG	CTGAAGATCCTGGAGACCAT          Zbtb16.R: TCCTCTCTCCCATAATGCAG
CTGAAGATCCTGGAGACCAT	TCCTCTCTCCCATAATGCAG	CTGAAGATCCTGGAGACCAT      Zbtb16.R: TCCTCTCTCCCATAATGCAG
CTGAAGATCCTGGAGACCAT	TCCTCTCTCCCATAATGCAG	CTGAAGATCCTGGAGACCAT              Zbtb16.R: TCCTCTCTCCCATAATGCAG
Seq_VPR_2_F	TCCTGCCGTGTTCACCGACCTGG	Seq_VPR_2_F    5'-TCCTGCCGTGTTCACCGACCTGG-3'
Transferrin	TCCTGCTGATTCCGAATG	Transferrin TCCTGCTGATTCCGAATG
Cas9check-F	TCCTGCTTAACCGCGAAGA	Cas9check-F      5' TCCTGCTTAACCGCGAAGA 3'
Human-GFAP:	TCCTGGAACAGCAAAACAAG	Human-GFAP:      F: TCCTGGAACAGCAAAACAAG
Human-GFAP:	TCCTGGAACAGCAAAACAAG	Human-GFAP:          F: TCCTGGAACAGCAAAACAAG
Human-GFAP:	TCCTGGAACAGCAAAACAAG	Human-GFAP:            F: TCCTGGAACAGCAAAACAAG
TDGF_Mel_For	TCCTTCTACGGACGGAACTG	TDGF_Mel_For   TCCTTCTACGGACGGAACTG
CNTN6_Ex9D_F	TCCTTCTGATCTCTACAGCCCT	CNTN6_Ex9D_F    TCCTTCTGATCTCTACAGCCCT
GFP_oIMR1416:	TCCTTGAAGAAGATGGTGCG	GFP_oIMR1416:  TCCTTGAAGAAGATGGTGCG
GFP_oIMR1416:	TCCTTGAAGAAGATGGTGCG	GFP_oIMR1416: TCCTTGAAGAAGATGGTGCG
CNTN6_Ex20D_F	TCCTTGTGGTTGTGGTTGAT	CNTN6_Ex20D_F  TCCTTGTGGTTGTGGTTGAT
07_top	tcgaaCCACCTTGCATCCCCATGAAAATagct	07_top 5'-tcgaaCCACCTTGCATCCCCATGAAAATagct-3'
2_top	tcgaaCCACTGTGGAGGAGGGGTCTACCagct	2_top 5'-tcgaaCCACTGTGGAGGAGGGGTCTACCagct-3'
71_top	tcgaaCCATCCTGTGTTCCGTGCCATTAagct	71_top 5'-tcgaaCCATCCTGTGTTCCGTGCCATTAagct-3'
45_top	tcgaaCCTCCTGCTAGGCTACTCTTCATagct	45_top 5'-tcgaaCCTCCTGCTAGGCTACTCTTCATagct-3'
40002_top	TCGAACCTCTTTTCAGCACTTACGGCGCAGCT	40002_top 5'-TCGAACCTCTTTTCAGCACTTACGGCGCAGCT-3'
27_top	tcgaaCTTAATAGACGAAGGTCATGAGGagct	27_top 5'-tcgaaCTTAATAGACGAAGGTCATGAGGagct-3'
invEND	TCGAAGCTTCTGCAGACGCG	invEND 5'-TCGAAGCTTCTGCAGACGCG-3'
4_top	tcgaaGGTCAAAGGTGGGTAGCTAGAGGagct	4_top 5'-tcgaaGGTCAAAGGTGGGTAGCTAGAGGagct-3'
30001_top	TCGACCCCGGCAAGGTTTTCGCTGGTCTAGCT	30001_top 5'-TCGACCCCGGCAAGGTTTTCGCTGGTCTAGCT-3'
40004_top	TCGACCTTCGGTAAGTTTCCTGTCTTCAGCT	40004_top 5'-TCGACCTTCGGTAAGTTTCCTGTCTTCAGCT-3'
5'-Molder-mid	TCGACGCTCAAGTCAGAGGTGGC	5'-Molder-mid TCGACGCTCAAGTCAGAGGTGGC
qRianF	TCGAGACACAAGAGGACTGC	qRianF TCGAGACACAAGAGGACTGC
Kdr_dr-gfp_top	TCGATGCCACGATTTGTTCATGACTGGTGAGCT	Kdr_dr-gfp_top 5-TCGATGCCACGATTTGTTCATGACTGGTGAGCT-3
136	TCGCATAGCCACACACCTTT	136 TCGCATAGCCACACACCTTT
109	TCGGAGGCAGAGAGTAGCTT	109         TCGGAGGCAGAGAGTAGCTT
F:5'-AGCTCGAGAGAACGCATCAG-3'	TCGGTCAGCAGTTTCCAGTC	F:5'-AGCTCGAGAGAACGCATCAG-3'    Sox3.R:5'-TCGGTCAGCAGTTTCCAGTC-3'
F:5'-AGCTCGAGAGAACGCATCAG-3'	TCGGTCAGCAGTTTCCAGTC	F:5'-AGCTCGAGAGAACGCATCAG-3'        Sox3.R:5'-TCGGTCAGCAGTTTCCAGTC-3'
CAGATTTGGAAACAAACGCC	TCGTAATACCTGCCCAGAAT	CAGATTTGGAAACAAACGCC              Pax6.R: TCGTAATACCTGCCCAGAAT
CAGATTTGGAAACAAACGCC	TCGTAATACCTGCCCAGAAT	CAGATTTGGAAACAAACGCC      Pax6.R: TCGTAATACCTGCCCAGAAT
CAGATTTGGAAACAAACGCC	TCGTAATACCTGCCCAGAAT	CAGATTTGGAAACAAACGCC          Pax6.R: TCGTAATACCTGCCCAGAAT
CAGATTTGGAAACAAACGCC	TCGTAATACCTGCCCAGAAT	CAGATTTGGAAACAAACGCC                    Pax6.R: TCGTAATACCTGCCCAGAAT
Mef_testR	TCGTCCGGCGAAGGTCTGGT	Mef_testR : 5-TCGTCCGGCGAAGGTCTGGT-3
CNTN6_Ex2D_F	TCGTGTTTGTACGTTTTTCATTTCA	CNTN6_Ex2D_F    TCGTGTTTGTACGTTTTTCATTTCA
BBB_r	TCGTTGGGAGTGAATTAGCC	BBB_r 5'-TCGTTGGGAGTGAATTAGCC-3'
BAC_Smcx_	TCGTTTTAGCGATGGGAAAC	BAC_Smcx_ 8   TCGTTTTAGCGATGGGAAAC
5_tail_REV_13	TCTAACGGACATCACCGACTGCCCATAGAGAGG	5_tail_REV_13  TCTAACGGACATCACCGACTGCCCATAGAGAGG
Seq_Cas9_domain_R	TCTAGAGGCTCGAGAGGATCAAC	Seq_Cas9_domain_R      5' TCTAGAGGCTCGAGAGGATCAAC 3'
PrF_gkdr1_KpnI:	tctagaggtaccGAAGAGGGCCTATTTC	PrF_gkdr1_KpnI:   tctagaggtaccGAAGAGGGCCTATTTC
5_tail_REV_15	TCTAGAGGTCATCACCGACTGCCCATAGAGAGG	5_tail_REV_15 TCTAGAGGTCATCACCGACTGCCCATAGAGAGG
NvKlf4F	TCTCCAATTCGCTGTCCCAT	NvKlf4F TCTCCAATTCGCTGTCCCAT
qmMycR	TCTCCACTCACCAGCACAACTACG	qmMycR 5-TCTCCACTCACCAGCACAACTACG-3
Kdr_98_CheckPrimer_R	TCTCCCAGGGCTCCTTAAAT	Kdr_98_CheckPrimer_R    5' TCTCCCAGGGCTCCTTAAAT 3'
GG-adaptor_UP	TCTCGAATTCctatcGAGACCGTGTGGTCTCtggcgACATGTACGT	GG-adaptor_UP  >>> TCTCGAATTCctatcGAGACCGTGTGGTCTCtggcgACATGTACGT
GG-adaptor_UP	TCTCGAATTCctatcGAGACCGTGTGGTCTCtggcgACATGTACGT	GG-adaptor_UP  > TCTCGAATTCctatcGAGACCGTGTGGTCTCtggcgACATGTACGT
F:GGCGCTCAATGCTGGCTTCA	TCTGCCTCCAGCCTCAGGTT	F:GGCGCTCAATGCTGGCTTCA    GFAP.R:TCTGCCTCCAGCCTCAGGTT
3'-Molder-out	TCTGCGCGTAATCTGCTGCTTGCA	3'-Molder-out TCTGCGCGTAATCTGCTGCTTGCA
qNvNanogR	TCTGCTGGAGGCTGAGGTAT	qNvNanogR    TCTGCTGGAGGCTGAGGTAT
5_tail_REV_16	TCTGGATGACATCACCGACTGCCCATAGAGAGG	5_tail_REV_16   TCTGGATGACATCACCGACTGCCCATAGAGAGG
CNTN6_Ex17D2_R	TCTGGCCAGTTAAATCTCTTTTCT	CNTN6_Ex17D2_R   TCTGGCCAGTTAAATCTCTTTTCT
Tph25UTR_31+EOS	TCTGGCTTAATCGCACTCATGGCTCCCGATGTAATTTTCT	Tph25UTR_31+EOS : TCTGGCTTAATCGCACT CATGG CTCCCGATGTAATTTTCT
hART1-RT-F	TCTGGGCCTTGCCATCTGGA	hART1-RT-F    5' TCTGGGCCTTGCCATCTGGA 3'
qckitR	TCTGGTGCCATCCACTTCAC	qckitR 5'-TCTGGTGCCATCCACTTCAC-3'
BAC_Smcx_4	TCTGTGCTTCTCAACATGCC	BAC_Smcx_4   TCTGTGCTTCTCAACATGCC
DTA_c-kit_F	tcttaagctcgggccTAGGTTGGAATCTAAAATACACAAAC	DTA_c-kit_F  5' tcttaagctcgggccTAGGTTGGAATCTAAAATACACAAAC 3'
gibsAP2Pr31	TCTTCTTCTTGGGCATGGTCGAGAATTTATCACTAGTGGCTGCAGCACAGGAGG	gibsAP2Pr31 : TCTTCTTCTTGGGCATGGTCGAGAATTTATCACTAGT GGCTGCAGCACAGGAGG
Tph2In12_33:	TCTTGTAAATATTGAAGCAAACAGA	Tph2In12_33:         TCTTGTAAATATTGAAGCAAACAGA
Tph2In12_33:	TCTTGTAAATATTGAAGCAAACAGA	Tph2In12_33:           TCTTGTAAATATTGAAGCAAACAGA
Oct4_Takahashi_F:	TCTTTCCACCAGGCCCCCGGCTC	Oct4_Takahashi_F:   TCTTTCCACCAGGCCCCCGGCTC
CNTN6_Ex17D_R	TCTTTCTGGCCAGTTAAATCTCT	CNTN6_Ex17D_R  TCTTTCTGGCCAGTTAAATCTCT
LD-G7-R:	TCTTTGTAGCCTTAATATTTGCTAT	LD-G7-R:  TCTTTGTAGCCTTAATATTTGCTAT
2nd	TCTTTGTCCTGTTACCGCCC	2nd peak2F 5'-TCTTTGTCCTGTTACCGCCC
Cdh3R	TCTTTTGGTTTGCAGAGACAGGG	Cdh3R 5'-TCTTTTGGTTTGCAGAGACAGGG-3'
-3'	TGAAAATGGCAGCCAAAGCC	-3'          Glast.R:5'-TGAAAATGGCAGCCAAAGCC -3'
-3'	TGAAAATGGCAGCCAAAGCC	-3'      Glast.R:5'-TGAAAATGGCAGCCAAAGCC -3'
1st	TGAAATGATCTCGTGGCGTCAT	1st peak check 2R  5' TGAAATGATCTCGTGGCGTCAT 3'
D5Mit208F	TGAACAGTTTGTTCCCTCCC	D5Mit208F  TGAACAGTTTGTTCCCTCCC
Alb	TGAACTGGCTGACTGCTGTG	Alb F TGAACTGGCTGACTGCTGTG
NNS-down	TGAATTCACAGTTAATCCCACCTGCAG	NNS-down 5'-TGAATTCACAGTTAATCCCACCTGCAG-3'
Oct4SNP:	TGAATTTAAAAGCCACTAGGGAAAGCCATGC	Oct4SNP: 5'-TGAATTTAAAAGCCACTAGGGAAAGCCATGC-3'
cTelHayesR	TGACCAGCAGGAAGTCGTCCACCA	cTelHayesR TGACCAGCAGGAAGTCGTCCACCA
CNTN6_Ex15D_R	TGACCCAAAACACTTTTGTCACT	CNTN6_Ex15D_R  TGACCCAAAACACTTTTGTCACT
qGFP-illg5:	TGACCCTGAAGTTCATCTGC	qGFP-illg5: 5'-TGACCCTGAAGTTCATCTGC-3'
GG-random25_UP	TGACGGTCTCTCTATNNNNNNNNNNNNNNNNNNNNNNNNNGGCGCGAGACCGTAA	GG-random25_UP  >>> TGACGGTCTCTCTATNNNNNNNNNNNNNNNNNNNNNNNNNGGCGCGAGACCGTAA
GG-random25_UP	TGACGGTCTCTCTATNNNNNNNNNNNNNNNNNNNNNNNNNGGCGCGAGACCGTAA	GG-random25_UP  > TGACGGTCTCTCTATNNNNNNNNNNNNNNNNNNNNNNNNNGGCGCGAGACCGTAA
Smcx_Pr3	TGAGCTTTCCCTTTCCCCAC	Smcx_Pr3 5'-TGAGCTTTCCCTTTCCCCAC
H19_Hum_new_OF	TGAGGGTTGGGGAGATGAGAGGA	H19_Hum_new_OF  TGAGGGTTGGGGAGATGAGAGGA  23
GM9_3_R	TGAGTCACAAGAAGCCACCC	GM9_3_R 5' TGAGTCACAAGAAGCCACCC 3'
4C_primer	TGATAGTTCCTGCTAGACATCCA	4C_primer 6_R  5' TGATAGTTCCTGCTAGACATCCA 3'
FLK1_Mel_For	TGATCGGAAATGACACTGGA	FLK1_Mel_For    TGATCGGAAATGACACTGGA
lvMKOS_recR	TGATTATCATATGACTAGtcacatgtgcgacaggggca	lvMKOS_recR  5-TGATTATCATATGACTAGtcacatgtgcgacaggggca-3
Gm11867-RT-1-F	TGATTGGAATTCTTCAGAGGCAAC	Gm11867-RT-1-F      5' TGATTGGAATTCTTCAGAGGCAAC 3'
Gm11867-RT-1-F	TGATTGGAATTCTTCAGAGGCAAC	Gm11867-RT-1-F          5' TGATTGGAATTCTTCAGAGGCAAC 3'
Cntn5ISr	TGATTGTTGTGCCCATGTTCTC	Cntn5ISr 5'-TGATTGTTGTGCCCATGTTCTC-3'
bsCMV51	TGATTTTATGGGATTTTTTTATTTG	bsCMV51 : 5-TGATTTTATGGGATTTTTTTATTTG-3
122	TGCACATGACCCATGACCTC	122 TGCACATGACCCATGACCTC
MycoVojdaniR	TGCACCATCTGTCACTCTGTTAACCTC	MycoVojdaniR   TGCACCATCTGTCACTCTGTTAACCTC
132	TGCACTTCATCCCTGGGAAA	132 TGCACTTCATCCCTGGGAAA
qNvNanogF	TGCAGAGGAGAGAACTGGGA	qNvNanogF    TGCAGAGGAGAGAACTGGGA
q-mGM2F1	TGCAGCATCTCTGCACCCGC	q-mGM2F1  TGCAGCATCTCTGCACCCGC
SRY_ME_F	TGCAGCGGTACAACGAAGAA	SRY_ME_F            TGCAGCGGTACAACGAAGAA
107	TGCAGGTATCCCACATGAACC	107         TGCAGGTATCCCACATGAACC
CNTN6_Ex21D_F	TGCATCATACTTTGACCATGAGC	CNTN6_Ex21D_F  TGCATCATACTTTGACCATGAGC
4C_primer	TGCATGGAATGTATGTTCAGAG	4C_primer 7_R  5' TGCATGGAATGTATGTTCAGAG 3'
Tph2In12_34	TGCATGTTAGCAAATCAAACCAC	Tph2In12_34 : TGCATGTTAGCAAATCAAACCAC
Seq_FVKO-Long_5H_R	tgccaatgcctgcatctgtg	Seq_FVKO-Long_5H_R    tgccaatgcctgcatctgtg
CNTN6_Ex17D2_F	TGCCATCCCACATTTCTCTTG	CNTN6_Ex17D2_F    TGCCATCCCACATTTCTCTTG
qGFP-illg3:	TGCCGTCCTCCTTGAAGTC	qGFP-illg3:  5'-TGCCGTCCTCCTTGAAGTC-3'
hcMYCMatF	TGCCTCAAATTGGACTTTGG	hcMYCMatF TGCCTCAAATTGGACTTTGG
NvDax1R	TGCCTCCTGTGTGTCATTCT	NvDax1R TGCCTCCTGTGTGTCATTCT
40_g1chr6cut1LF	TGCCTCGGTGGATATTGTGT	40_g1chr6cut1LF    TGCCTCGGTGGATATTGTGT
c-myc-up	tgccttaagtctagtatcacgtgcagatcgctacaacgac	c-myc-up 5'-tgccttaagtctagtatcacgtgcagatcgctacaacgac-3'
Cre-35:	TGCGAACCTCATCACTCGTT	Cre-35: TGCGAACCTCATCACTCGTT
CASCUT-B	TGCGCGCATAACTAAGCATC	CASCUT-B    F: TGCGCGCATAACTAAGCATC
19_T	TGCGCTTCAAGGAGCTAACTA	19_T 1-2_R: TGCGCTTCAAGGAGCTAACTA
Oct4_Takahashi_R:	TGCGGGCGGACATGGGGAGATCC	Oct4_Takahashi_R:   TGCGGGCGGACATGGGGAGATCC
TAF4_dupIN1_R	TGCGGGTAGCAAAAACCCTAA	TAF4_dupIN1_R    TGCGGGTAGCAAAAACCCTAA
cTelHayesF	TGCGTCTGGTACACAATCACGTC	cTelHayesF TGCGTCTGGTACACAATCACGTC
Afp	TGCGTGAATTATGCAGAAGC	Afp r TGCGTGAATTATGCAGAAGC
BAC_Smcx_6	TGCTACCCACTCCTGAAGCT	BAC_Smcx_6   TGCTACCCACTCCTGAAGCT
tgfbr3_TaqI_check_R	TGCTCAGGACTCATGTTCCA	tgfbr3_TaqI_check_R   5' TGCTCAGGACTCATGTTCCA 3'
tgfbr3_TaqI_check_R	TGCTCAGGACTCATGTTCCA	tgfbr3_TaqI_check_R   3' TGCTCAGGACTCATGTTCCA 5'
qThy1F:	TGCTCTCAGTCTTGCAGGTG	qThy1F: TGCTCTCAGTCTTGCAGGTG 20bp
gCCCGCCACTCCGGCTCCCAGggaagcggagccactaact	tgctcttgtccagtctagacattggcccgggattctcttc	gCCCGCCACTCCGGCTCCCAGggaagcggagccactaact    R2 - tgctcttgtccagtctagacattggcccgggattctcttc
mEos2_52:	TGCTGTTGCTCATTCTGGAT	mEos2_52:         TGCTGTTGCTCATTCTGGAT
mEos2_52:	TGCTGTTGCTCATTCTGGAT	mEos2_52:           TGCTGTTGCTCATTCTGGAT
CNTN6_Ex18D_R	TGGAACAAGGGAACACAAACT	CNTN6_Ex18D_R  TGGAACAAGGGAACACAAACT
5'-Molder-inn	TGGAAGCTCCCTCGTGCGCTCT	5'-Molder-inn TGGAAGCTCCCTCGTGCGCTCT
mCNTN5-RT-Ex9_F	TGGAATATTGGCGATCCAGAGTG	mCNTN5-RT-Ex9_F      5' TGGAATATTGGCGATCCAGAGTG 3'
35_BracheyryR2	tggacaTATCGGCTGCAGAATTAATCACTAGTACCGGTCCTCCCGCCA	35_BracheyryR2 : tggacaTATCGGCTGCAGAATTAATCACTAGTACCGGTCCTCCCGCCA
108	TGGAGCACAAGTCTCATGTCAA	108         TGGAGCACAAGTCTCATGTCAA
qThy1R:	TGGATGGAGTTATCCTTGGTGTT	qThy1R: TGGATGGAGTTATCCTTGGTGTT 23bp
H-VIMENTIN:	TGGCACGTCTTGACCTTGAA	H-VIMENTIN:    F-TGGCACGTCTTGACCTTGAA
GRE-check-R	TGGCAGACTTTTGCTTCCGAGCT	GRE-check-R TGGCAGACTTTTGCTTCCGAGCT
3'mTg	TGGCAGGACTTCTTGGAGCTCGA	3'mTg        5'-TGGCAGGACTTCTTGGAGCTCGA-3'
Foxa2	TGGCTGCAGACACTTCCTACT	Foxa2  >>>> F TGGCTGCAGACACTTCCTACT
Foxa2	TGGCTGCAGACACTTCCTACT	Foxa2  >> F TGGCTGCAGACACTTCCTACT
Foxa2	TGGCTGCAGACACTTCCTACT	Foxa2  F  TGGCTGCAGACACTTCCTACT
mCNTN5-RT-Ex3_F	TGGCTTCGGAATGGAACTGAA	mCNTN5-RT-Ex3_F      5' TGGCTTCGGAATGGAACTGAA 3'
Hind_primer_15F	TGGGACAACCCTCAAAGCTT	Hind_primer_15F  5' TGGGACAACCCTCAAAGCTT 3'
4C_primer	TGGGACAACCCTCAAAGCTT	4C_primer 3_F  5' TGGGACAACCCTCAAAGCTT 3'
Dpn_primer_15R	TGGGCAGAAGCTACTGATGAA	Dpn_primer_15R  5' TGGGCAGAAGCTACTGATGAA 3'
31:00:00	TGGGCCAGGATTCTCCTCGACG	31: TGGGCCAGGATTCTCCTCGACG
hCNTN6i12_51	TGGGCTAAAGGCCAAACTAA	hCNTN6i12_51 TGGGCTAAAGGCCAAACTAA
121	TGGGTCCTTGGAGAGGAACA	121 TGGGTCCTTGGAGAGGAACA
chickHi-C3	TGGGTGACAGTGAGGGTACA	chickHi-C3 5'-TGGGTGACAGTGAGGGTACA-3'
RNF169R	tggtctcagatcctacttggccccggccatgt	RNF169R 5'-tggtctcagatcctacttggccccggccatgt
Cntn5ISf	TGGTGAAGGCAAACGTAAGAAT	Cntn5ISf 5'-TGGTGAAGGCAAACGTAAGAAT-3'
D12Mit8R	TGGTGACTCCTTACAGAGGC	D12Mit8R  TGGTGACTCCTTACAGAGGC
G-CSF	TGGTGAGTGAGTGTGCCACC	G-CSF RNA F: 5'- TGGTGAGTGAGTGTGCCACC -3'
D3S3050F	TGGTGGTATGCATTTGTCAG	D3S3050F    TGGTGGTATGCATTTGTCAG
CNTN6_Ex14D2_R	TGGTGTGGTTTCTCAGAGGT	CNTN6_Ex14D2_R  TGGTGTGGTTTCTCAGAGGT
CNTN6_Ex14D_R	TGGTGTGGTTTCTCAGAGGTC	CNTN6_Ex14D_R  TGGTGTGGTTTCTCAGAGGTC
qPpiaR	TGTAAAGTCACCACCCTGGCACAT	qPpiaR  5'-TGTAAAGTCACCACCCTGGCACAT-3'
qPpiaR	TGTAAAGTCACCACCCTGGCACAT	qPpiaR  TGTAAAGTCACCACCCTGGCACAT
Kdr_A_F	tgtacaaaaaagcaggcCTAACACAACCTGGGCAC	Kdr_A_F  5' tgtacaaaaaagcaggcCTAACACAACCTGGGCAC 3'
C-kit_A_F	tgtacaaaaaagcaggcGACTCACTGAGATGAAATGAAATG	C-kit_A_F  5' tgtacaaaaaagcaggcGACTCACTGAGATGAAATGAAATG 3'
Tgfbr3-A_F:	tgtacaaaaaagcaggcGCAGGCTCTAGATGGTCC	Tgfbr3-A_F: 5' tgtacaaaaaagcaggcGCAGGCTCTAGATGGTCC  3'
kdr_up_F	tgtacaaaaaagcaggcGGGGACAACTGGAGGACAAA	kdr_up_F    5' tgtacaaaaaagcaggcGGGGACAACTGGAGGACAAA 3'
tgfbr_UP_F	tgtacaaaaaagcaggcTCTCGGCTTCTGGCAATGTT	tgfbr_UP_F 5'-tgtacaaaaaagcaggcTCTCGGCTTCTGGCAATGTT-3'
q-mGapdhR	TGTAGACCATGTAGTTGAGGTCA	q-mGapdhR  TGTAGACCATGTAGTTGAGGTCA   23b
3-G8-conf	TGTAGGAGTCTGTGGGAGAAGGA	3-G8-conf TGTAGGAGTCTGTGGGAGAAGGA
MAR-iTg	TGTCAATTGTCCCGTACGACCCTCTCA	MAR-iTg 5'-TGTCAATTGTCCCGTACGACCCTCTCA-3'
130	TGTCCAACTCTGTAGGGCAAA	130 TGTCCAACTCTGTAGGGCAAA
Dpn_primer_13R	TGTCTGAACCGAGATGATGG	Dpn_primer_13R  5' TGTCTGAACCGAGATGATGG 3'
qMap2_51	TGTGCTGTGTGCTCCAAGTT	qMap2_51 TGTGCTGTGTGCTCCAAGTT
37_g1chr15cut2LF	TGTGGTGGTAACCTGTCAACT	37_g1chr15cut2LF    TGTGGTGGTAACCTGTCAACT
bsIG-DMR-f2	TGTGGTTTGTTATGGGTAAGTTTTATGGTTTATTG	bsIG-DMR-f2    5'-TGTGGTTTGTTATGGGTAAGTTTTATGGTTTATTG-3'
Ddx3x_Pr2	TGTGTGCTGTAGCCAGTGTT	Ddx3x_Pr2 5'-TGTGTGCTGTAGCCAGTGTT
17_Rosa	tgtgtgggcgttgtcctg	17_Rosa 1-2_R: tgtgtgggcgttgtcctg
qNCAM_51	TGTTCAAGCAGACACACCGT	qNCAM_51 TGTTCAAGCAGACACACCGT
kdr_down_F	TGTTCATGACTGGTGGCTCA	kdr_down_F    5' TGTTCATGACTGGTGGCTCA 3'
bsIGCf1	TTAAGGTATTTTTTATTGATAAAATAATGTAGTTT	bsIGCf1 5'-TTA AGG TAT TTT TTA TTG ATA AAA TAA TGT AGT TT-3'
pTub3+GFP_31	ttacctgcagaagagtttatgagggcgcgccGAGTCGCGGCCGCTTTA	pTub3+GFP_31 ttacctgcagaagagtttatgagggcgcgccGAGTCGCGGCCGCTTTA
mGata4-innerR	TTACGCGGTGATTATGTCCCCATG	mGata4-innerR : 5-TTACGCGGTGATTATGTCCCCATG-3
GG-random25_DOWN	TTACGGTCTCGCGCC	GG-random25_DOWN  > TTACGGTCTCGCGCC
GG-random25_DOWN	TTACGGTCTCGCGCC	GG-random25_DOWN  >>> TTACGGTCTCGCGCC
RT-mCNBD1-2-F	TTACTGACGGGCCAGGCTCG	RT-mCNBD1-2-F      5' TTACTGACGGGCCAGGCTCG 3'
Tbx5-Inner-R	TTAGCTATTCTCACTCCACTCTGGCAC	Tbx5-Inner-R : 5-TTAGCTATTCTCACTCCACTCTGGCAC-3
bsIGCf2	TTAGGAGTTAAGGAAAAGAAAGAAATAGTATAGT	bsIGCf2 5'-TTA GGA GTT AAG GAA AAG AAA GAA ATA GTA TAG T-3'
Seq_GMCSF_1_F	TTCAATGGCCAGGAGTCACCA	Seq_GMCSF_1_F    TTCAATGGCCAGGAGTCACCA
Seq_CtIP_1	TTCCAAGTCTTCAACTCATCCACA	Seq_CtIP_1      5' TTCCAAGTCTTCAACTCATCCACA 3'
tltkpA_53	TTCCCTTCCTTTCTCGCCAC	tltkpA_53 : TTCCCTTCCTTTCTCGCCAC
Ttr	TTCCTGAGCTGCTAACACGG	Ttr R TTCCTGAGCTGCTAACACGG
3C_Anopheles_2F	TTCGCGTGTCATTAGCAG	3C_Anopheles_2F   5' TTCGCGTGTCATTAGCAG 3'
Tgfbr3-A_R:	ttcggaataggaacttcCGTCCCTGAGCTAGGAAATTAG	Tgfbr3-A_R: 5' ttcggaataggaacttcCGTCCCTGAGCTAGGAAATTAG  3'
kdr_up_R	ttcggaataggaacttcCGTGGCAAATTTAGGCAAGGA	kdr_up_R    5' ttcggaataggaacttcCGTGGCAAATTTAGGCAAGGA 3'
Kdr_A_R	ttcggaataggaacttcGCTGTCAGAGGCCCAACT	Kdr_A_R  5' ttcggaataggaacttcGCTGTCAGAGGCCCAACT 3'
tgfbr_UP_R	ttcggaataggaacttcTAAGCACCAGTCCTGAATCAG	tgfbr_UP_R 5'-ttcggaataggaacttcTAAGCACCAGTCCTGAATCAG-3'
C-kit_A_R	ttcggaataggaacttcTGAGAGGCAAGGGGAGAC	C-kit_A_R  5' ttcggaataggaacttcTGAGAGGCAAGGGGAGAC 3'
Mef2BudR	ttcggatccTCATGTTGCCCATCCTTCAGA	Mef2BudR : 5-ttcggatccTCATGTTGCCCATCCTTCAGA-3
EScaseinGM_3H_OUT_R	ttctagggacagggggctaa	EScaseinGM_3H_OUT_R    ttctagggacagggggctaa
CNTN6_Ex1D_R	TTCTCATTGCAGCAGACACAG	CNTN6_Ex1D_R    TTCTCATTGCAGCAGACACAG
Vermintide-R:	TTCTCCCATGGTGTCTCGACTGC	Vermintide-R:        5'-TTCTCCCATGGTGTCTCGACTGC-3'
Vermintide-R:	TTCTCCCATGGTGTCTCGACTGC	Vermintide-R:    5'-TTCTCCCATGGTGTCTCGACTGC-3'
mEos_ex12_F	TTCTGCTGTGCCAGAAGATCA	mEos_ex12_F TTCTGCTGTGCCAGAAGATCA
102	TTCTGGAGGTGCTGACGTTC	102         TTCTGGAGGTGCTGACGTTC
4C_primer	TTCTGGGTAGCCGGTCAG	4C_primer 8_R   5' TTCTGGGTAGCCGGTCAG 3'
RT-mCNBD1-3-F	TTGAAATTAATCCGCAAGTGTCC	RT-mCNBD1-3-F        5' TTGAAATTAATCCGCAAGTGTCC 3'
qMirgF	TTGACTCCAGAAGATGCTCC	qMirgF  TTGACTCCAGAAGATGCTCC
qGtl2f	TTGCACATTTCCTGTGGGAC	qGtl2f TTGCACATTTCCTGTGGGAC
CNTN6_Ex4D_F	TTGCAGGAATTAGAACTACATGTTT	CNTN6_Ex4D_F    TTGCAGGAATTAGAACTACATGTTT
mCNTN5-RT-Ex15_R	TTGCCAGCCCAGGGAGAAGG	mCNTN5-RT-Ex15_R      5' TTGCCAGCCCAGGGAGAAGG 3'
DTA_F:	ttgccatccagctgatAGGTTGGAATCTAAAATACACAAAC	DTA_F: 5'  ttgccatccagctgatAGGTTGGAATCTAAAATACACAAAC 3'
D12Mit8F	TTGCCTAACCCACTCACACC	D12Mit8F  TTGCCTAACCCACTCACACC
Sox2_Takahashi_R:	TTGCCTTAAACAAGACCACGAAA	Sox2_Takahashi_R:  TTGCCTTAAACAAGACCACGAAA
hSOX2MatR	TTGCGTGAGTGTGGATGGGATTGGTG	hSOX2MatR TTGCGTGAGTGTGGATGGGATTGGTG
PrR_gc-kit2_PciI	ttgctcacatgtGAAAGCTGGGTCTAGA	PrR_gc-kit2_PciI ttgctcacatgtGAAAGCTGGGTCTAGA
PrR_gkdr1_KpnI:	ttgctcggtaccGAAAGCTGGGTCTAGA	PrR_gkdr1_KpnI:  ttgctcggtaccGAAAGCTGGGTCTAGA
q-mNanogF	TTGCTTACAAGGGTCTGCTACT	q-mNanogF  TTGCTTACAAGGGTCTGCTACT   22b
119	TTGGAGTTTCGCCATCAGGT	119 TTGGAGTTTCGCCATCAGGT
EScaseinGM_5H_F	TTGGCTGAGGTTAATTAGCTGAG	EScaseinGM_5H_F    5'-TTGGCTGAGGTTAATTAGCTGAG-3'
EScaseinGM_5H_F	TTGGCTGAGGTTAATTAGCTGAG	EScaseinGM_5H_F      5' TTGGCTGAGGTTAATTAGCTGAG 3'
EScaseinGM_5H_F	TTGGCTGAGGTTAATTAGCTGAG	EScaseinGM_5H_F  5' TTGGCTGAGGTTAATTAGCTGAG 3'
EScaseinGM_5H_F	ttggctgaggttaattagctgag	EScaseinGM_5H_F      ttggctgaggttaattagctgag
M2rt_BamHIF	ttgGGATCCcgggaattaattcaccatgt	M2rt_BamHIF 5'-ttgGGATCCcgggaattaattcaccatgt-3'
4C_primer	TTGGGTACATGGGACAAAGCTT	4C_primer 5_F  5' TTGGGTACATGGGACAAAGCTT 3'
GM9_4_R	TTGGTACACAATGCCTGCAA	GM9_4_R      5' TTGGTACACAATGCCTGCAA 3'
tgfbr_check_R	TTGTCCGAGACACACACACA	tgfbr_check_R   5' TTGTCCGAGACACACACACA 3'
SRY_F	TTGTCTAGAGAGCATGGAGGGCCATGTCAA	SRY_F : TTG TCT AGA GAG CAT GGA GGG CCA TGT CAA
4C_primer	TTGTGCGTGAAAATGTTAGT	4C_primer 2_R  5' TTGTGCGTGAAAATGTTAGT 3'
D3S1744F	TTTAAGCGGAAGGAAGTGTG	D3S1744F    TTTAAGCGGAAGGAAGTGTG
FOS-up	TTTAAGTATCCCATTAGCATCCAAACAAAGAGTTTTC	FOS-up 5'-TTTAAGTATCCCATTAGCATCCAAACAAAGAGTTTTC-3'
FmOmS-up	TTTAAGTATCCCTTTCAAATCCACCTGTCCAGTTTTC	FmOmS-up 5'-TTTAAGTATCCCTTTCAAATCCACCTGTCCAGTTTTC-3'
promTRE_XbaIF	TttCTAGactcgagtttaccactccctatc	promTRE_XbaIF 5'-TttCTAGactcgagtttaccactccctatc-3'
Csn1s1-mid-R	TTTCTTGCCCATTGCTTGACC	Csn1s1-mid-R      5' TTTCTTGCCCATTGCTTGACC 3'
kdr_guide_2_top	TTTCTTGGCTTTATATATCTTGTGGAAAGGACGAAACAccaCGATTTGTTCATGACTGGTG	kdr_guide_2_top           5' TTTCTTGGCTTTATATATCTTGTGGAAAGGACGAAACAccaCGATTTGTTCATGACTGGTG
tgfbr_grna_top_s	TTTCTTGGCTTTATATATCTTGTGGAAAGGACGAAACACCGAAACCCTTCCCTCATCGAA	tgfbr_grna_top_s 5'-TTTCTTGGCTTTATATATCTTGTGGAAAGGACGAAACACCGAAACCCTTCCCTCATCGAA-3'
gInsF14	TTTCTTGGCTTTATATATCTTGTGGAAAGGACGAAACACCGAGTGGAAATGAGGTTGCTA	gInsF14 TTTCTTGGCTTTATATATCTTGTGGAAAGGACGAAACACC G AGTG GAAAT GAGGT TGCTA
gInsF15	TTTCTTGGCTTTATATATCTTGTGGAAAGGACGAAACACCGATGAGGTTGCTATGGAAAC	gInsF15 TTTCTTGGCTTTATATATCTTGTGGAAAGGACGAAACACC G ATGA GGTTG CTATG GAAAC
gInsF13	TTTCTTGGCTTTATATATCTTGTGGAAAGGACGAAACACCGCACTCATAAACTCTTCTGC	gInsF13 TTTCTTGGCTTTATATATCTTGTGGAAAGGACGAAACACC G CACT CATAA ACTCT TCTGC
gInsF18	TTTCTTGGCTTTATATATCTTGTGGAAAGGACGAAACACCGcagtctccggtgttctcta	gInsF18 TTTCTTGGCTTTATATATCTTGTGGAAAGGACGAAACACC G cagtctccggtgttctcta
Esp_adaptor	TTTCTTGGCTTTATATATCTTGTGGAAAGGACGAAACACCGGAGACGatgcatCGTCTC	Esp_adaptor up 5'-TTTCTTGGCTTTATATATCTTGTGGAAAGGACGAAACACCGGAGACGatgcatCGTCTC-3'
gInsF17	TTTCTTGGCTTTATATATCTTGTGGAAAGGACGAAACACCGgtgttctctagggcatcaa	gInsF17 TTTCTTGGCTTTATATATCTTGTGGAAAGGACGAAACACC G gtgttctctagggcatcaa
Rnf12_gRNAup	TTTCTTGGCTTTATATATCTTGTGGAAAGGACGAAACACCGtcggccagaccttctcgag	Rnf12_gRNAup 5'-TTTCTTGGCTTTATATATCTTGTGGAAAGGACGAAACACCGtcggccagaccttctcgag-3'
gInsF16	TTTCTTGGCTTTATATATCTTGTGGAAAGGACGAAACACCGtctacagcaggtgtccata	gInsF16 TTTCTTGGCTTTATATATCTTGTGGAAAGGACGAAACACC G tctacagcaggtgtccata
c-kit_guide_2_top	TTTCTTGGCTTTATATATCTTGTGGAAAGGACGAAACAcctCTCACACGAATTGCTCAGTA	c-kit_guide_2_top           5' TTTCTTGGCTTTATATATCTTGTGGAAAGGACGAAACAcctCTCACACGAATTGCTCAGTA 3'
hNANOGMatF	TTTGGAAGCTGCTGGGGAAG	hNANOGMatF TTTGGAAGCTGCTGGGGAAG
Sox	TTTGTGTATAAGCCCGAGATGG	Sox 17F 5'-TTTGTGTATAAGCCCGAGATGG-3'
2-GRE-mut-S	TTTTGGATGTTAATTTACATGAATGCCATTCCATTTCCTATA	2-GRE-mut-S TTTTGGATGTTAATTTACATGAATGCCATTCCATTTCCTATA
MicePeg3OR	TTTTGTAGAGGATTTTGATAAGGAGGTG	MicePeg3OR  > 5'-TTTTGTAGAGGATTTTGATAAGGAGGTG-3'
MicePeg3OR	TTTTGTAGAGGATTTTGATAAGGAGGTG	MicePeg3OR  > >> 5'-TTTTGTAGAGGATTTTGATAAGGAGGTG-3'
hECAT15-1-AS916	TTTTTCCTGATATTCTATTCCCAT	hECAT15-1-AS916 TTT TTC CTG ATA TTC TAT TCC CAT
21_poliA+Cas9+GFP_31:	ttttttttttttttttttttTGGCAACTAGAAGGCACAGT	21_poliA+Cas9+GFP_31: 5' ttttttttttttttttttttTGGCAACTAGAAGGCACAGT 3'
D6Mit105R:5'	CAAAAGCCTTATATATTACACCTCACC	D6Mit105R:5'-CAAAAGCCTTATATATTACACCTCACC                       ,
D6Mit105R:5'-	CAAAAGCCTTATATATTACACCTCACC	D6Mit105R:5'-CAAAAGCCTTATATATTACACCTCACC                   ,
Kostja-Cas9-R1	TACCAAACAGGCCGTTCTTC
Kostja-CMV-DsRed-PciI-f	tagtaaacatgtacggggtcattagttcatagcc
Kostja-CMV-E1f	cagcagACATGTagtttatcgataagcttggga
Kostja-CMV-f	ATAGGGACTTNCCATTGACGTCAATGGGTG
Kostja-CMV-Kozak-R	cCATggtggcggcTCTGACGGTTCACTAAACC
Kostja-CMV-Pr1	tcggtgtcttctatggaggtcaaaacagcgtggat
Kostja-CMV-Pr1-koz	gctcaccatggtggcgaggtcaaaacagcgtggat
Kostja-CMV-r	ACCGCCCANTTGCGTCAATGGGGCGGAGTT
Kostja-CMV-Tomato-f	catagaagacaccgaatggtgagcaagggcgagga
Kostja-CMV-Tomato-F-Koz	gacctcgccaccatggtgagcaagggcgagga
Kostja-Cox8-Kozak-F	gccgccaccATGgCCGTCCTGACGCCGCTGCT
Kostja-DsRed-1R	gcgtgatgaacttcgaggac
Kostja-DsRed-PA-r	tatgatcagttacaggaacaggtggtggcggc
Kostja-DsRsd-2F	gtcctcgaagttcatcacgc
Kostja-DT-A_seq-f	tgtggaattgtgagcggata
Kostja-DT-A_seq-r	cactagctggtggatggaca
Kostja-DT-A-f	GGCCCGGTACCAGATCTATAGATCATGAG
Kostja-DTA-int-f	ACTTTTAGTGCGAGAACCTTCG
Kostja-DTA-int-r	CGAAGGTTCTCGCACTAAAAGT
Kostja-DT-A-NdeI-f	agcttCATATGAGATCTATAGATCATGAG
Kostja-DTA-PspOMI-r	GAGCTCgggcccCGGAGACGGTCACAGCTT
Kostja-DT-A-r	CATGCggtaccCGGAGACGGTCACAGCTT
Kostja-DTA-SalI-f	AAGCTTgtcgacAGATCTATAGATCATGAG
Kostja-DT-A-SalI-r	agctcGTCGACCGGAGACGGTCACAGCTT
Kostja-EGFP-f	gcacaagctggagtacaactacaacagcca
Kostja-EGFP-Lox-U	acttgtacagcNcgtccatgccgagagtgatc
Kostja-EGFP-r	tggctgttgtagttgtactccagcttgtgc
Kostja-EGFP-TubbP	ccgcgtgaagtcagcatggtgagcaagggcgagga
Kostja-Ex1-EcoRI	atcaagGAATTctgtctgccacttgctgtgt
Kostja-Ex1-P2A-U	atgagggagaNcgtgcacatccaggccggc
Kostja-f1-ori-r	taacgcgaattctaacaaaatattaacgctt
Kostja-Fr1.F	atgcctgcaggtcgactcctgattctgcttcc
Kostja-Fr1.R	ttgtacagctcgtccatgccgagagtgat
Kostja-Fr2.F	ggcatggacgagctgtacaagtcatattcaat
Kostja-Fr2.R	atctccctcattggcccgggattctcttcg
Kostja-Fr3.F	atcccgggccaatgagggagatcgtgcacat
Kostja-Fr3.R	accatgattacgaattctgtctgccacttgctgtg
Kostja-gBlock1-f	ATGGGCGGNAGGCGTGTACGGTGGGAGG
Kostja-gBlock1-r	ATGAGGTTCNTCTTTATGCTGTGGCGATC
Kostja-gBlock2-f	AGAAAGCGGNACACCTCTACAAAGGAGGT
Kostja-gBlock2-r	AGAAGCCGNAGCCCATCACGTGGCTCAG
Kostja-gBlock3-f	AGCTGGGCANCGTGGAGTACCAGCACGCC
Kostja-gBlock3-r	ACATGTTCTTNCCTGCGTTATCCCCTGATT
Kostja-gBlock4-f	ATCAGGGTTANTGTCTCATGAGCGGATACA
Kostja-gBlock4-r	AAAGTCCCTANTGGCGTTACTATGGGAACA
Kostja-GFP-G0	gaacttcaagatccgccacaacatcgaggac
Kostja-GFP-G2	gcgatcacatggtcctgctggagttcgtgac
Kostja-GSG-k	AAGGCTAGCggaagcgga
Kostja-hCas9-f	AGAACCTCANTGGCGCCCTCCTGTTCGAC
Kostja-hCas9-r	ACCGCTTTCNGTCTATGGTGGTGTCGAAG
Kostja-Ins-EGFP-RLC	ggacttgaagaagtcgtgctg
Kostja-Ins-FRC	cagcctctgttccacatacact
Kostja-Int-1F	agtcgggattgagcacagaa
Kostja-Int-3F	tggggtgcctaatgagtgag
Kostja-L-for	GTGGAATTGTGAGCGGATAAC
Kostja-Lox-EGFP-U	agctgtacaagNcatattcaataacccttaat
Kostja-Lox-P2A	ggctccgcttccagtgaacctcttcgagggaccta
Kostja-L-rev	CCCGGGATTCTCTTCGACATC
Kostja-M13.F	GTAAAACGACGGCCAGT
Kostja-M13.R	CAGGAAACAGCTATGAC
Kostja-Ori-2R	gtagcaccgcctacatacct
Kostja-Ori-3R	gtttcgccacctctgacttg
Kostja-Ori-f	AAAGAACATGNGAGCAAAAGGCCAGCAAAA
Kostja-P2a-Ex1-U	atctccctcaNtggcccgggattctcttcg
Kostja-P2A-GSG	cccaaggctagcggaagcggagccactaacttctccctgt
Kostja-P2A-lox	cgaagaggttcactggaagcggagccactaacttc
Kostja-P2A-rev	gcttggctggacgtaaactc
Kostja-pCR8_F1	TTGATGCCTGGCAGTTCCCT
Kostja-pCR8_R1	CGAACCGAACAGGCTTATGT
Kostja-PGK-r	ctaaagcgcatgctccagact
Kostja-pUC-Ori-f	GGGATAACGCAGGAAAGAACATGTGA
Kostja-Red2A F	CCCGGCTACTACTACGTGGA	Nariman Nastya
Kostja-R-for	TGGTCGAGATCCGGAACCCTT
Kostja-R-rev	TCCCAGTCACGACGTTGTAAA
Kostja-SeqTALEN_5-1	CATCGCGCAATGCACTGAC
Kostja-SV40PA-DsRed-f	acctgttcctgtaactgatcataatcagccatac
Kostja-SV40PA-Ori-r	ctttcctgcgttatcccACGCCTTAAGATACATTGATGA
Kostja-SV40PA-PciI-r	cgcttaacatgtacgcgttaagatacattg
Kostja-T2mut-F	gtgaggctgagATgtcAggTgtcctgcgtcc
Kostja-T2mut-R	ggacgcaggacAccTgacATctcagcctcac
Kostja-TAL_F1	TTGGCGTCGGCAAACAGTGG
Kostja-TAL_R2	GGCGACGAGGTGGTCGTTGG
Kostja-TAL1-2L-SDM-for	tccgagtaTcaAcaAtaTcaAgaTgccactgcgga
Kostja-TAL1-2L-SDM-rev	tccgcagtggcAtcTtgAtaTtgTtgAtactcgga
Kostja-TAL3Rn-SDM-for	accagctcatGaAgTAtGATagCAtaaagtccttc
Kostja-TAL3Rn-SDM-rev	gaaggactttaTGctATCaTAcTtCatgagctggt
Kostja-TAL3R-SDM-for	tcaccagctcattaAgTAtGATagCAtTC
Kostja-TAL3R-SDM-rev	GAaTGctATCaTAcTtaatgagctggtga
Kostja-TALR2_Seq	ccctttttcactgcatcc
Kostja-Tomato-r	ggtagcacatgtattgctacttgtgattgctc
Kostja-TRPV1 1F	actctgtggtccccaagatg
Kostja-TRPV1 1R	tcctcataagggcagtccat
Kostja-TRPV1 2-3 R	gacaacagagctgacggtga
Kostja-TRPV1 2-3F	ggaggcacagctctgaaaac
Kostja-TRPV1-gRNA1-F	tttcttggctttatatatcttgtggaaaggacgaaacaccgctggaggcggcttggagtt
Kostja-TRPV1-gRNA1-R	gactagccttattttaacttgctatttctagctctaaaacaactccaagccgcctccagc
Kostja-TRPV1-gRNA2-F	tttcttggctttatatatcttgtggaaaggacgaaacaccgtccgggcaggagttctctt
Kostja-TRPV1-gRNA2-R	gactagccttattttaacttgctatttctagctctaaaacaagagaactcctgcccggac
Kostja-TRPV1-gRNA3-F	tttcttggctttatatatcttgtggaaaggacgaaacaccgaaaagccgggtgcgactcc
Kostja-TRPV1-gRNA3-R	gactagccttattttaacttgctatttctagctctaaaacggagtcgcacccggcttttc
Kostja-Tubb3_LS-f	agatgtcgtgcggaaagagt
Kostja-Tubb3_LS-r	gaacttcagggtcagcttgc
Kostja-Tubb3_RS-f	gcctgaagaacgagatcagc
Kostja-Tubb3_RS-r	atggagccagtacagggttg
Kostja-Tubb3-3R	TCTCCAATACCAGGCAGAGG
Kostja-Tubb3-5F	GTCAAGGTAGCCGTGTGTGA
Kostja-Tubb3-Asc	GGGCGGCGCGCCAGTTGCTCGCAGCTGGGGTG
Kostja-Tubb3-Bam	TCACGGATCCGGGGCACAGGCTCAGGCATG
Kostja-Tubb3-FLC	ctcataggtcagagtggtgctg
Kostja-Tubb3-gRNA1-F	tttcttggctttatatatcttgtggaaaggacgaaacaccgcgccgcgccctcttataag
Kostja-Tubb3-gRNA1-R	gactagccttattttaacttgctatttctagctctaaaaccttataagagggcgcggcgc
Kostja-Tubb3-gRNA2-F	tttcttggctttatatatcttgtggaaaggacgaaacaccgggggacgcaggacgccgga
Kostja-Tubb3-gRNA2-R	gactagccttattttaacttgctatttctagctctaaaactccggcgtcctgcgtccccc
Kostja-Tubb3-gRNA3-F	tttcttggctttatatatcttgtggaaaggacgaaacaccggcaagtctggccgcgcctt
Kostja-Tubb3-gRNA3-R	gactagccttattttaacttgctatttctagctctaaaacaaggcgcggccagacttgcc
Kostja-Tubb3-Nhe	AGCAGCTAGCCTTGGGCCCCTGGGCTTCCG
Kostja-Tubb3-Not	GTAGGCGGCCGCGGAAGAATGCTGGATATGAG
Kostja-Tubb3-RRC	caggtagcccttctcaaaagc
Kostja-TubbP-DTA-r	ggtacaagtgagggtgaagagg
Kostja-TubbP-EGFP	gcccttgctcaccatgctgacttcacgcggctaga
Kostja-TubbP-Sal	atttgccagctgtcctgattctgcttcccaat
Kostja-TubbP-SalI	atttgcGTCGACtcctgattctgcttcccaat
Kostja-TurboGFP-f	ACGGCTTCNACCACTTCGGCACCTACCC
Kostja-TurboGFP-r	ATGCCCAGCNCGGTGTTGCTGTGATCCTC
Kostja-VpUC18.F	gacagaattcgtaatcatggtcatagctgtttcct
Kostja-VpUC18.R	aggagtcgacctgcaggcatgc